date,price,next_price,diff_price,action,reward,cumulated_reward
2000-01-01,29951,29951,0,1,0.0,0.0
2000-01-02,29951,29951,0,-1,-0.0,0.0
2000-01-03,29951,27247,-2704,0,-0.0,0.0
2000-01-04,27247,27553,306,0,0.0,0.0
2000-01-05,27553,25920,-1633,1,-1633.0,-1633.0
2000-01-06,25920,26482,562,-1,-562.0,-2195.0
2000-01-07,26482,26482,0,1,0.0,-2195.0
2000-01-08,26482,26482,0,1,0.0,-2195.0
2000-01-09,26482,26278,-204,-1,204.0,-1991.0
2000-01-10,26278,25920,-358,1,-358.0,-2349.0
2000-01-11,25920,26533,613,0,0.0,-2349.0
2000-01-12,26533,24594,-1939,0,-0.0,-2349.0
2000-01-13,24594,25818,1224,-1,-1224.0,-3573.0
2000-01-14,25818,25818,0,1,0.0,-3573.0
2000-01-15,25818,25818,0,0,0.0,-3573.0
2000-01-16,25818,25410,-408,1,-408.0,-3981.0
2000-01-17,25410,26125,715,-1,-715.0,-4696.0
2000-01-18,26125,24492,-1633,-1,1633.0,-3063.0
2000-01-19,24492,23675,-817,-1,817.0,-2246.0
2000-01-20,23675,23267,-408,0,-0.0,-2246.0
2000-01-21,23267,23267,0,-1,-0.0,-2246.0
2000-01-22,23267,23267,0,-1,-0.0,-2246.0
2000-01-23,23267,23420,153,0,0.0,-2246.0
2000-01-24,23420,22043,-1377,1,-1377.0,-3623.0
2000-01-25,22043,22298,255,1,255.0,-3368.0
2000-01-26,22298,23675,1377,-1,-1377.0,-4745.0
2000-01-27,23675,26533,2858,0,0.0,-4745.0
2000-01-28,26533,26533,0,0,0.0,-4745.0
2000-01-29,26533,26533,0,0,0.0,-4745.0
2000-01-30,26533,26074,-459,0,-0.0,-4745.0
2000-01-31,26074,26227,153,0,0.0,-4745.0
2000-02-01,26227,26941,714,1,714.0,-4031.0
2000-02-02,26941,26635,-306,0,-0.0,-4031.0
2000-02-03,26635,26635,0,0,0.0,-4031.0
2000-02-04,26635,26635,0,0,0.0,-4031.0
2000-02-05,26635,26635,0,-1,-0.0,-4031.0
2000-02-06,26635,26431,-204,0,-0.0,-4031.0
2000-02-07,26431,26227,-204,0,-0.0,-4031.0
2000-02-08,26227,25410,-817,0,-0.0,-4031.0
2000-02-09,25410,24492,-918,1,-918.0,-4949.0
2000-02-10,24492,23982,-510,-1,510.0,-4439.0
2000-02-11,23982,23982,0,0,0.0,-4439.0
2000-02-12,23982,23982,0,0,0.0,-4439.0
2000-02-13,23982,23471,-511,-1,511.0,-3928.0
2000-02-14,23471,23675,204,0,0.0,-3928.0
2000-02-15,23675,24900,1225,-1,-1225.0,-5153.0
2000-02-16,24900,24492,-408,1,-408.0,-5561.0
2000-02-17,24492,25920,1428,0,0.0,-5561.0
2000-02-18,25920,25920,0,0,0.0,-5561.0
2000-02-19,25920,25920,0,-1,-0.0,-5561.0
2000-02-20,25920,24288,-1632,1,-1632.0,-7193.0
2000-02-21,24288,24798,510,1,510.0,-6683.0
2000-02-22,24798,26635,1837,1,1837.0,-4846.0
2000-02-23,26635,30615,3980,1,3980.0,-866.0
2000-02-24,30615,30207,-408,1,-408.0,-1274.0
2000-02-25,30207,30207,0,-1,-0.0,-1274.0
2000-02-26,30207,30207,0,1,0.0,-1274.0
2000-02-27,30207,28574,-1633,-1,1633.0,359.0
2000-02-28,28574,30615,2041,-1,-2041.0,-1682.0
2000-02-29,30615,30615,0,1,0.0,-1682.0
2000-03-01,30615,31329,714,-1,-714.0,-2396.0
2000-03-02,31329,28472,-2857,1,-2857.0,-5253.0
2000-03-03,28472,28472,0,0,0.0,-5253.0
2000-03-04,28472,28472,0,1,0.0,-5253.0
2000-03-05,28472,28472,0,1,0.0,-5253.0
2000-03-06,28472,29696,1224,-1,-1224.0,-6477.0
2000-03-07,29696,28574,-1122,-1,1122.0,-5355.0
2000-03-08,28574,28064,-510,0,-0.0,-5355.0
2000-03-09,28064,32248,4184,1,4184.0,-1171.0
2000-03-10,32248,32248,0,0,0.0,-1171.0
2000-03-11,32248,32248,0,1,0.0,-1171.0
2000-03-12,32248,34901,2653,-1,-2653.0,-3824.0
2000-03-13,34901,31635,-3266,-1,3266.0,-558.0
2000-03-14,31635,30615,-1020,1,-1020.0,-1578.0
2000-03-15,30615,28676,-1939,1,-1939.0,-3517.0
2000-03-16,28676,27655,-1021,1,-1021.0,-4538.0
2000-03-17,27655,27655,0,1,0.0,-4538.0
2000-03-18,27655,27655,0,-1,-0.0,-4538.0
2000-03-19,27655,28523,868,1,868.0,-3670.0
2000-03-20,28523,26737,-1786,1,-1786.0,-5456.0
2000-03-21,26737,27349,612,0,0.0,-5456.0
2000-03-22,27349,27655,306,-1,-306.0,-5762.0
2000-03-23,27655,28676,1021,0,0.0,-5762.0
2000-03-24,28676,28676,0,-1,-0.0,-5762.0
2000-03-25,28676,28676,0,-1,-0.0,-5762.0
2000-03-26,28676,28931,255,0,0.0,-5762.0
2000-03-27,28931,29594,663,0,0.0,-5762.0
2000-03-28,29594,28370,-1224,1,-1224.0,-6986.0
2000-03-29,28370,28574,204,-1,-204.0,-7190.0
2000-03-30,28574,29084,510,1,510.0,-6680.0
2000-03-31,29084,29084,0,0,0.0,-6680.0
2000-04-01,29084,29084,0,1,0.0,-6680.0
2000-04-02,29084,27655,-1429,0,-0.0,-6680.0
2000-04-03,27655,28268,613,1,613.0,-6067.0
2000-04-04,28268,28268,0,1,0.0,-6067.0
2000-04-05,28268,26941,-1327,0,-0.0,-6067.0
2000-04-06,26941,26635,-306,0,-0.0,-6067.0
2000-04-07,26635,26635,0,-1,-0.0,-6067.0
2000-04-08,26635,26635,0,-1,-0.0,-6067.0
2000-04-09,26635,27502,867,-1,-867.0,-6934.0
2000-04-10,27502,27706,204,-1,-204.0,-7138.0
2000-04-11,27706,27655,-51,1,-51.0,-7189.0
2000-04-12,27655,27655,0,0,0.0,-7189.0
2000-04-13,27655,28064,409,-1,-409.0,-7598.0
2000-04-14,28064,28064,0,-1,-0.0,-7598.0
2000-04-15,28064,28064,0,1,0.0,-7598.0
2000-04-16,28064,25002,-3062,1,-3062.0,-10660.0
2000-04-17,25002,25716,714,-1,-714.0,-11374.0
2000-04-18,25716,27553,1837,0,0.0,-11374.0
2000-04-19,27553,28574,1021,1,1021.0,-10353.0
2000-04-20,28574,28727,153,1,153.0,-10200.0
2000-04-21,28727,28727,0,0,0.0,-10200.0
2000-04-22,28727,28727,0,1,0.0,-10200.0
2000-04-23,28727,28370,-357,-1,357.0,-9843.0
2000-04-24,28370,27655,-715,1,-715.0,-10558.0
2000-04-25,27655,27655,0,-1,-0.0,-10558.0
2000-04-26,27655,27043,-612,1,-612.0,-11170.0
2000-04-27,27043,27145,102,0,0.0,-11170.0
2000-04-28,27145,27145,0,-1,-0.0,-11170.0
2000-04-29,27145,27145,0,0,0.0,-11170.0
2000-04-30,27145,27145,0,0,0.0,-11170.0
2000-05-01,27145,26431,-714,-1,714.0,-10456.0
2000-05-02,26431,25512,-919,1,-919.0,-11375.0
2000-05-03,25512,25563,51,1,51.0,-11324.0
2000-05-04,25563,25563,0,1,0.0,-11324.0
2000-05-05,25563,25563,0,0,0.0,-11324.0
2000-05-06,25563,25563,0,-1,-0.0,-11324.0
2000-05-07,25563,25563,0,0,0.0,-11324.0
2000-05-08,25563,26176,613,0,0.0,-11324.0
2000-05-09,26176,26023,-153,-1,153.0,-11171.0
2000-05-10,26023,26023,0,-1,-0.0,-11171.0
2000-05-11,26023,24492,-1531,1,-1531.0,-12702.0
2000-05-12,24492,24492,0,-1,-0.0,-12702.0
2000-05-13,24492,24492,0,-1,-0.0,-12702.0
2000-05-14,24492,23675,-817,-1,817.0,-11885.0
2000-05-15,23675,23675,0,-1,-0.0,-11885.0
2000-05-16,23675,21430,-2245,1,-2245.0,-14130.0
2000-05-17,21430,20206,-1224,0,-0.0,-14130.0
2000-05-18,20206,21226,1020,1,1020.0,-13110.0
2000-05-19,21226,21226,0,1,0.0,-13110.0
2000-05-20,21226,21226,0,1,0.0,-13110.0
2000-05-21,21226,19287,-1939,1,-1939.0,-15049.0
2000-05-22,19287,19900,613,0,0.0,-15049.0
2000-05-23,19900,20410,510,-1,-510.0,-15559.0
2000-05-24,20410,21124,714,-1,-714.0,-16273.0
2000-05-25,21124,18879,-2245,0,-0.0,-16273.0
2000-05-26,18879,18879,0,0,0.0,-16273.0
2000-05-27,18879,18879,0,0,0.0,-16273.0
2000-05-28,18879,18063,-816,1,-816.0,-17089.0
2000-05-29,18063,18777,714,1,714.0,-16375.0
2000-05-30,18777,19644,867,0,0.0,-16375.0
2000-05-31,19644,19338,-306,-1,306.0,-16069.0
2000-06-01,19338,19389,51,-1,-51.0,-16120.0
2000-06-02,19389,19389,0,-1,-0.0,-16120.0
2000-06-03,19389,19389,0,1,0.0,-16120.0
2000-06-04,19389,20410,1021,0,0.0,-16120.0
2000-06-05,20410,20410,0,-1,-0.0,-16120.0
2000-06-06,20410,21532,1122,-1,-1122.0,-17242.0
2000-06-07,21532,20002,-1530,0,-0.0,-17242.0
2000-06-08,20002,20614,612,0,0.0,-17242.0
2000-06-09,20614,20614,0,-1,-0.0,-17242.0
2000-06-10,20614,20614,0,1,0.0,-17242.0
2000-06-11,20614,22043,1429,0,0.0,-17242.0
2000-06-12,22043,20920,-1123,1,-1123.0,-18365.0
2000-06-13,20920,20665,-255,0,-0.0,-18365.0
2000-06-14,20665,19389,-1276,1,-1276.0,-19641.0
2000-06-15,19389,18879,-510,-1,510.0,-19131.0
2000-06-16,18879,18879,0,0,0.0,-19131.0
2000-06-17,18879,18879,0,1,0.0,-19131.0
2000-06-18,18879,18777,-102,1,-102.0,-19233.0
2000-06-19,18777,18981,204,1,204.0,-19029.0
2000-06-20,18981,18930,-51,0,-0.0,-19029.0
2000-06-21,18930,18930,0,-1,-0.0,-19029.0
2000-06-22,18930,18828,-102,0,-0.0,-19029.0
2000-06-23,18828,18828,0,0,0.0,-19029.0
2000-06-24,18828,18828,0,1,0.0,-19029.0
2000-06-25,18828,19185,357,-1,-357.0,-19386.0
2000-06-26,19185,21226,2041,0,0.0,-19386.0
2000-06-27,21226,21328,102,0,0.0,-19386.0
2000-06-28,21328,21328,0,1,0.0,-19386.0
2000-06-29,21328,21328,0,1,0.0,-19386.0
2000-06-30,21328,21328,0,1,0.0,-19386.0
2000-07-01,21328,21328,0,-1,-0.0,-19386.0
2000-07-02,21328,21941,613,1,613.0,-18773.0
2000-07-03,21941,23880,1939,0,0.0,-18773.0
2000-07-04,23880,25920,2040,0,0.0,-18773.0
2000-07-05,25920,27655,1735,1,1735.0,-17038.0
2000-07-06,27655,27094,-561,0,-0.0,-17038.0
2000-07-07,27094,27094,0,0,0.0,-17038.0
2000-07-08,27094,27094,0,-1,-0.0,-17038.0
2000-07-09,27094,25614,-1480,-1,1480.0,-15558.0
2000-07-10,25614,26125,511,-1,-511.0,-16069.0
2000-07-11,26125,27961,1836,1,1836.0,-14233.0
2000-07-12,27961,28064,103,0,0.0,-14233.0
2000-07-13,28064,26533,-1531,-1,1531.0,-12702.0
2000-07-14,26533,26533,0,0,0.0,-12702.0
2000-07-15,26533,26533,0,1,0.0,-12702.0
2000-07-16,26533,26533,0,0,0.0,-12702.0
2000-07-17,26533,25410,-1123,0,-0.0,-12702.0
2000-07-18,25410,24492,-918,-1,918.0,-11784.0
2000-07-19,24492,25002,510,0,0.0,-11784.0
2000-07-20,25002,25002,0,-1,-0.0,-11784.0
2000-07-21,25002,25002,0,-1,-0.0,-11784.0
2000-07-22,25002,25002,0,0,0.0,-11784.0
2000-07-23,25002,23777,-1225,0,-0.0,-11784.0
2000-07-24,23777,24798,1021,0,0.0,-11784.0
2000-07-25,24798,25512,714,-1,-714.0,-12498.0
2000-07-26,25512,25614,102,0,0.0,-12498.0
2000-07-27,25614,23982,-1632,-1,1632.0,-10866.0
2000-07-28,23982,23982,0,0,0.0,-10866.0
2000-07-29,23982,23982,0,1,0.0,-10866.0
2000-07-30,23982,24237,255,0,0.0,-10866.0
2000-07-31,24237,24033,-204,-1,204.0,-10662.0
2000-08-01,24033,23777,-256,1,-256.0,-10918.0
2000-08-02,23777,23216,-561,0,-0.0,-10918.0
2000-08-03,23216,22043,-1173,1,-1173.0,-12091.0
2000-08-04,22043,22043,0,0,0.0,-12091.0
2000-08-05,22043,22043,0,0,0.0,-12091.0
2000-08-06,22043,20818,-1225,-1,1225.0,-10866.0
2000-08-07,20818,20920,102,0,0.0,-10866.0
2000-08-08,20920,21430,510,-1,-510.0,-11376.0
2000-08-09,21430,22859,1429,1,1429.0,-9947.0
2000-08-10,22859,22043,-816,0,-0.0,-9947.0
2000-08-11,22043,22043,0,0,0.0,-9947.0
2000-08-12,22043,22043,0,-1,-0.0,-9947.0
2000-08-13,22043,22451,408,-1,-408.0,-10355.0
2000-08-14,22451,22451,0,-1,-0.0,-10355.0
2000-08-15,22451,23267,816,-1,-816.0,-11171.0
2000-08-16,23267,22910,-357,-1,357.0,-10814.0
2000-08-17,22910,22961,51,-1,-51.0,-10865.0
2000-08-18,22961,22961,0,-1,-0.0,-10865.0
2000-08-19,22961,22961,0,-1,-0.0,-10865.0
2000-08-20,22961,22298,-663,1,-663.0,-11528.0
2000-08-21,22298,22400,102,-1,-102.0,-11630.0
2000-08-22,22400,22196,-204,1,-204.0,-11834.0
2000-08-23,22196,21634,-562,-1,562.0,-11272.0
2000-08-24,21634,21890,256,1,256.0,-11016.0
2000-08-25,21890,21890,0,0,0.0,-11016.0
2000-08-26,21890,21890,0,-1,-0.0,-11016.0
2000-08-27,21890,22094,204,0,0.0,-11016.0
2000-08-28,22094,22196,102,1,102.0,-10914.0
2000-08-29,22196,21839,-357,-1,357.0,-10557.0
2000-08-30,21839,21532,-307,1,-307.0,-10864.0
2000-08-31,21532,21430,-102,0,-0.0,-10864.0
2000-09-01,21430,21430,0,1,0.0,-10864.0
2000-09-02,21430,21430,0,0,0.0,-10864.0
2000-09-03,21430,21839,409,-1,-409.0,-11273.0
2000-09-04,21839,22451,612,1,612.0,-10661.0
2000-09-05,22451,22043,-408,1,-408.0,-11069.0
2000-09-06,22043,21839,-204,1,-204.0,-11273.0
2000-09-07,21839,21430,-409,-1,409.0,-10864.0
2000-09-08,21430,21430,0,1,0.0,-10864.0
2000-09-09,21430,21430,0,0,0.0,-10864.0
2000-09-10,21430,21430,0,1,0.0,-10864.0
2000-09-11,21430,21430,0,-1,-0.0,-10864.0
2000-09-12,21430,21430,0,0,0.0,-10864.0
2000-09-13,21430,20818,-612,0,-0.0,-10864.0
2000-09-14,20818,20410,-408,0,-0.0,-10864.0
2000-09-15,20410,20410,0,0,0.0,-10864.0
2000-09-16,20410,20410,0,1,0.0,-10864.0
2000-09-17,20410,19338,-1072,0,-0.0,-10864.0
2000-09-18,19338,19185,-153,1,-153.0,-11017.0
2000-09-19,19185,20308,1123,-1,-1123.0,-12140.0
2000-09-20,20308,19849,-459,1,-459.0,-12599.0
2000-09-21,19849,19900,51,-1,-51.0,-12650.0
2000-09-22,19900,19900,0,0,0.0,-12650.0
2000-09-23,19900,19900,0,-1,-0.0,-12650.0
2000-09-24,19900,20410,510,0,0.0,-12650.0
2000-09-25,20410,19798,-612,-1,612.0,-12038.0
2000-09-26,19798,20716,918,1,918.0,-11120.0
2000-09-27,20716,20308,-408,0,-0.0,-11120.0
2000-09-28,20308,20614,306,-1,-306.0,-11426.0
2000-09-29,20614,20614,0,1,0.0,-11426.0
2000-09-30,20614,20614,0,-1,-0.0,-11426.0
2000-10-01,20614,20155,-459,0,-0.0,-11426.0
2000-10-02,20155,20155,0,-1,-0.0,-11426.0
2000-10-03,20155,20614,459,1,459.0,-10967.0
2000-10-04,20614,20257,-357,-1,357.0,-10610.0
2000-10-05,20257,19185,-1072,1,-1072.0,-11682.0
2000-10-06,19185,19185,0,-1,-0.0,-11682.0
2000-10-07,19185,19185,0,-1,-0.0,-11682.0
2000-10-08,19185,18165,-1020,-1,1020.0,-10662.0
2000-10-09,18165,18573,408,-1,-408.0,-11070.0
2000-10-10,18573,17706,-867,1,-867.0,-11937.0
2000-10-11,17706,16328,-1378,1,-1378.0,-13315.0
2000-10-12,16328,15307,-1021,1,-1021.0,-14336.0
2000-10-13,15307,15307,0,-1,-0.0,-14336.0
2000-10-14,15307,15307,0,0,0.0,-14336.0
2000-10-15,15307,16277,970,-1,-970.0,-15306.0
2000-10-16,16277,16124,-153,1,-153.0,-15459.0
2000-10-17,16124,16124,0,-1,-0.0,-15459.0
2000-10-18,16124,16532,408,0,0.0,-15459.0
2000-10-19,16532,16634,102,1,102.0,-15357.0
2000-10-20,16634,16634,0,0,0.0,-15357.0
2000-10-21,16634,16634,0,-1,-0.0,-15357.0
2000-10-22,16634,17297,663,1,663.0,-14694.0
2000-10-23,17297,17246,-51,0,-0.0,-14694.0
2000-10-24,17246,16226,-1020,0,-0.0,-14694.0
2000-10-25,16226,16532,306,1,306.0,-14388.0
2000-10-26,16532,17501,969,-1,-969.0,-15357.0
2000-10-27,17501,17501,0,1,0.0,-15357.0
2000-10-28,17501,17501,0,1,0.0,-15357.0
2000-10-29,17501,17348,-153,1,-153.0,-15510.0
2000-10-30,17348,19287,1939,1,1939.0,-13571.0
2000-10-31,19287,20818,1531,0,0.0,-13571.0
2000-11-01,20818,20410,-408,-1,408.0,-13163.0
2000-11-02,20410,20920,510,0,0.0,-13163.0
2000-11-03,20920,20920,0,-1,-0.0,-13163.0
2000-11-04,20920,20920,0,0,0.0,-13163.0
2000-11-05,20920,19900,-1020,-1,1020.0,-12143.0
2000-11-06,19900,19389,-511,1,-511.0,-12654.0
2000-11-07,19389,20206,817,1,817.0,-11837.0
2000-11-08,20206,19440,-766,-1,766.0,-11071.0
2000-11-09,19440,19491,51,-1,-51.0,-11122.0
2000-11-10,19491,19491,0,-1,-0.0,-11122.0
2000-11-11,19491,19491,0,0,0.0,-11122.0
2000-11-12,19491,19695,204,0,0.0,-11122.0
2000-11-13,19695,19747,52,1,52.0,-11070.0
2000-11-14,19747,19134,-613,0,-0.0,-11070.0
2000-11-15,19134,19593,459,1,459.0,-10611.0
2000-11-16,19593,19593,0,-1,-0.0,-10611.0
2000-11-17,19593,19593,0,-1,-0.0,-10611.0
2000-11-18,19593,19593,0,-1,-0.0,-10611.0
2000-11-19,19593,19287,-306,1,-306.0,-10917.0
2000-11-20,19287,19236,-51,-1,51.0,-10866.0
2000-11-21,19236,18675,-561,0,-0.0,-10866.0
2000-11-22,18675,18267,-408,0,-0.0,-10866.0
2000-11-23,18267,18267,0,1,0.0,-10866.0
2000-11-24,18267,18267,0,-1,-0.0,-10866.0
2000-11-25,18267,18267,0,-1,-0.0,-10866.0
2000-11-26,18267,19185,918,-1,-918.0,-11784.0
2000-11-27,19185,18930,-255,-1,255.0,-11529.0
2000-11-28,18930,17757,-1173,0,-0.0,-11529.0
2000-11-29,17757,18165,408,0,0.0,-11529.0
2000-11-30,18165,18777,612,-1,-612.0,-12141.0
2000-12-01,18777,18777,0,0,0.0,-12141.0
2000-12-02,18777,18777,0,-1,-0.0,-12141.0
2000-12-03,18777,18165,-612,-1,612.0,-11529.0
2000-12-04,18165,18522,357,0,0.0,-11529.0
2000-12-05,18522,17859,-663,-1,663.0,-10866.0
2000-12-06,17859,17961,102,-1,-102.0,-10968.0
2000-12-07,17961,18267,306,0,0.0,-10968.0
2000-12-08,18267,18267,0,1,0.0,-10968.0
2000-12-09,18267,18267,0,0,0.0,-10968.0
2000-12-10,18267,18981,714,-1,-714.0,-11682.0
2000-12-11,18981,18369,-612,1,-612.0,-12294.0
2000-12-12,18369,19695,1326,1,1326.0,-10968.0
2000-12-13,19695,19287,-408,-1,408.0,-10560.0
2000-12-14,19287,19236,-51,1,-51.0,-10611.0
2000-12-15,19236,19236,0,-1,-0.0,-10611.0
2000-12-16,19236,19236,0,0,0.0,-10611.0
2000-12-17,19236,19032,-204,-1,204.0,-10407.0
2000-12-18,19032,18318,-714,1,-714.0,-11121.0
2000-12-19,18318,16940,-1378,-1,1378.0,-9743.0
2000-12-20,16940,17348,408,0,0.0,-9743.0
2000-12-21,17348,16736,-612,0,-0.0,-9743.0
2000-12-22,16736,16736,0,-1,-0.0,-9743.0
2000-12-23,16736,16736,0,-1,-0.0,-9743.0
2000-12-24,16736,16736,0,-1,-0.0,-9743.0
2000-12-25,16736,18369,1633,1,1633.0,-8110.0
2000-12-26,18369,18369,0,-1,-0.0,-8110.0
2000-12-27,18369,18369,0,1,0.0,-8110.0
2000-12-28,18369,18369,0,-1,-0.0,-8110.0
2000-12-29,18369,18369,0,-1,-0.0,-8110.0
2000-12-30,18369,18369,0,-1,-0.0,-8110.0
2000-12-31,18369,18369,0,-1,-0.0,-8110.0
2001-01-01,18369,17859,-510,1,-510.0,-8620.0
2001-01-02,17859,17450,-409,-1,409.0,-8211.0
2001-01-03,17450,17757,307,0,0.0,-8211.0
2001-01-04,17757,16940,-817,0,-0.0,-8211.0
2001-01-05,16940,16940,0,1,0.0,-8211.0
2001-01-06,16940,16940,0,0,0.0,-8211.0
2001-01-07,16940,16940,0,-1,-0.0,-8211.0
2001-01-08,16940,17297,357,-1,-357.0,-8568.0
2001-01-09,17297,17603,306,1,306.0,-8262.0
2001-01-10,17603,17348,-255,-1,255.0,-8007.0
2001-01-11,17348,17042,-306,1,-306.0,-8313.0
2001-01-12,17042,17042,0,0,0.0,-8313.0
2001-01-13,17042,17042,0,1,0.0,-8313.0
2001-01-14,17042,17297,255,0,0.0,-8313.0
2001-01-15,17297,17144,-153,-1,153.0,-8160.0
2001-01-16,17144,17144,0,1,0.0,-8160.0
2001-01-17,17144,16991,-153,-1,153.0,-8007.0
2001-01-18,16991,17246,255,1,255.0,-7752.0
2001-01-19,17246,17246,0,-1,-0.0,-7752.0
2001-01-20,17246,17246,0,0,0.0,-7752.0
2001-01-21,17246,17859,613,1,613.0,-7139.0
2001-01-22,17859,17859,0,1,0.0,-7139.0
2001-01-23,17859,17859,0,-1,-0.0,-7139.0
2001-01-24,17859,17859,0,0,0.0,-7139.0
2001-01-25,17859,17246,-613,1,-613.0,-7752.0
2001-01-26,17246,17246,0,1,0.0,-7752.0
2001-01-27,17246,17246,0,0,0.0,-7752.0
2001-01-28,17246,17093,-153,1,-153.0,-7905.0
2001-01-29,17093,17042,-51,0,-0.0,-7905.0
2001-01-30,17042,17552,510,-1,-510.0,-8415.0
2001-01-31,17552,17399,-153,0,-0.0,-8415.0
2001-02-01,17399,17552,153,1,153.0,-8262.0
2001-02-02,17552,17552,0,0,0.0,-8262.0
2001-02-03,17552,17552,0,1,0.0,-8262.0
2001-02-04,17552,17144,-408,0,-0.0,-8262.0
2001-02-05,17144,17246,102,-1,-102.0,-8364.0
2001-02-06,17246,17042,-204,-1,204.0,-8160.0
2001-02-07,17042,17399,357,1,357.0,-7803.0
2001-02-08,17399,17706,307,0,0.0,-7803.0
2001-02-09,17706,17706,0,1,0.0,-7803.0
2001-02-10,17706,17706,0,-1,-0.0,-7803.0
2001-02-11,17706,17757,51,0,0.0,-7803.0
2001-02-12,17757,17450,-307,1,-307.0,-8110.0
2001-02-13,17450,17399,-51,0,-0.0,-8110.0
2001-02-14,17399,18318,919,-1,-919.0,-9029.0
2001-02-15,18318,18165,-153,-1,153.0,-8876.0
2001-02-16,18165,18165,0,0,0.0,-8876.0
2001-02-17,18165,18165,0,0,0.0,-8876.0
2001-02-18,18165,17552,-613,1,-613.0,-9489.0
2001-02-19,17552,17961,409,-1,-409.0,-9898.0
2001-02-20,17961,18165,204,0,0.0,-9898.0
2001-02-21,18165,17808,-357,1,-357.0,-10255.0
2001-02-22,17808,18471,663,1,663.0,-9592.0
2001-02-23,18471,18471,0,-1,-0.0,-9592.0
2001-02-24,18471,18471,0,-1,-0.0,-9592.0
2001-02-25,18471,19849,1378,1,1378.0,-8214.0
2001-02-26,19849,19849,0,-1,-0.0,-8214.0
2001-02-27,19849,19389,-460,0,-0.0,-8214.0
2001-02-28,19389,19389,0,0,0.0,-8214.0
2001-03-01,19389,18369,-1020,-1,1020.0,-7194.0
2001-03-02,18369,18369,0,0,0.0,-7194.0
2001-03-03,18369,18369,0,-1,-0.0,-7194.0
2001-03-04,18369,18369,0,1,0.0,-7194.0
2001-03-05,18369,18420,51,1,51.0,-7143.0
2001-03-06,18420,18369,-51,-1,51.0,-7092.0
2001-03-07,18369,18879,510,0,0.0,-7092.0
2001-03-08,18879,18573,-306,-1,306.0,-6786.0
2001-03-09,18573,18573,0,0,0.0,-6786.0
2001-03-10,18573,18573,0,1,0.0,-6786.0
2001-03-11,18573,17501,-1072,0,-0.0,-6786.0
2001-03-12,17501,16889,-612,0,-0.0,-6786.0
2001-03-13,16889,17246,357,-1,-357.0,-7143.0
2001-03-14,17246,18369,1123,1,1123.0,-6020.0
2001-03-15,18369,17859,-510,-1,510.0,-5510.0
2001-03-16,17859,17859,0,1,0.0,-5510.0
2001-03-17,17859,17859,0,-1,-0.0,-5510.0
2001-03-18,17859,17910,51,0,0.0,-5510.0
2001-03-19,17910,17910,0,-1,-0.0,-5510.0
2001-03-20,17910,18522,612,-1,-612.0,-6122.0
2001-03-21,18522,18726,204,-1,-204.0,-6326.0
2001-03-22,18726,18828,102,-1,-102.0,-6428.0
2001-03-23,18828,18828,0,1,0.0,-6428.0
2001-03-24,18828,18828,0,-1,-0.0,-6428.0
2001-03-25,18828,18828,0,0,0.0,-6428.0
2001-03-26,18828,18369,-459,1,-459.0,-6887.0
2001-03-27,18369,18369,0,-1,-0.0,-6887.0
2001-03-28,18369,18369,0,-1,-0.0,-6887.0
2001-03-29,18369,18063,-306,0,-0.0,-6887.0
2001-03-30,18063,18063,0,1,0.0,-6887.0
2001-03-31,18063,18063,0,1,0.0,-6887.0
2001-04-01,18063,17859,-204,1,-204.0,-7091.0
2001-04-02,17859,17655,-204,0,-0.0,-7091.0
2001-04-03,17655,17655,0,1,0.0,-7091.0
2001-04-04,17655,17655,0,-1,-0.0,-7091.0
2001-04-05,17655,17706,51,-1,-51.0,-7142.0
2001-04-06,17706,17706,0,-1,-0.0,-7142.0
2001-04-07,17706,17706,0,1,0.0,-7142.0
2001-04-08,17706,17706,0,-1,-0.0,-7142.0
2001-04-09,17706,17706,0,-1,-0.0,-7142.0
2001-04-10,17706,17706,0,-1,-0.0,-7142.0
2001-04-11,17706,17757,51,-1,-51.0,-7193.0
2001-04-12,17757,17655,-102,-1,102.0,-7091.0
2001-04-13,17655,17655,0,-1,-0.0,-7091.0
2001-04-14,17655,17655,0,0,0.0,-7091.0
2001-04-15,17655,17501,-154,0,-0.0,-7091.0
2001-04-16,17501,17348,-153,1,-153.0,-7244.0
2001-04-17,17348,17552,204,1,204.0,-7040.0
2001-04-18,17552,17603,51,0,0.0,-7040.0
2001-04-19,17603,17603,0,-1,-0.0,-7040.0
2001-04-20,17603,17603,0,-1,-0.0,-7040.0
2001-04-21,17603,17603,0,0,0.0,-7040.0
2001-04-22,17603,17603,0,0,0.0,-7040.0
2001-04-23,17603,17808,205,1,205.0,-6835.0
2001-04-24,17808,18267,459,1,459.0,-6376.0
2001-04-25,18267,17859,-408,1,-408.0,-6784.0
2001-04-26,17859,17859,0,0,0.0,-6784.0
2001-04-27,17859,17859,0,0,0.0,-6784.0
2001-04-28,17859,17859,0,1,0.0,-6784.0
2001-04-29,17859,18012,153,-1,-153.0,-6937.0
2001-04-30,18012,18012,0,-1,-0.0,-6937.0
2001-05-01,18012,17706,-306,0,-0.0,-6937.0
2001-05-02,17706,17655,-51,0,-0.0,-6937.0
2001-05-03,17655,17757,102,-1,-102.0,-7039.0
2001-05-04,17757,17757,0,0,0.0,-7039.0
2001-05-05,17757,17757,0,-1,-0.0,-7039.0
2001-05-06,17757,17961,204,-1,-204.0,-7243.0
2001-05-07,17961,17757,-204,0,-0.0,-7243.0
2001-05-08,17757,17655,-102,1,-102.0,-7345.0
2001-05-09,17655,17655,0,-1,-0.0,-7345.0
2001-05-10,17655,18165,510,1,510.0,-6835.0
2001-05-11,18165,18165,0,-1,-0.0,-6835.0
2001-05-12,18165,18165,0,-1,-0.0,-6835.0
2001-05-13,18165,18420,255,0,0.0,-6835.0
2001-05-14,18420,18573,153,0,0.0,-6835.0
2001-05-15,18573,18573,0,-1,-0.0,-6835.0
2001-05-16,18573,18573,0,1,0.0,-6835.0
2001-05-17,18573,19389,816,1,816.0,-6019.0
2001-05-18,19389,19389,0,0,0.0,-6019.0
2001-05-19,19389,19389,0,1,0.0,-6019.0
2001-05-20,19389,19695,306,0,0.0,-6019.0
2001-05-21,19695,19389,-306,-1,306.0,-5713.0
2001-05-22,19389,19389,0,0,0.0,-5713.0
2001-05-23,19389,22298,2909,1,2909.0,-2804.0
2001-05-24,22298,25614,3316,-1,-3316.0,-6120.0
2001-05-25,25614,25614,0,1,0.0,-6120.0
2001-05-26,25614,25614,0,0,0.0,-6120.0
2001-05-27,25614,25512,-102,-1,102.0,-6018.0
2001-05-28,25512,24390,-1122,-1,1122.0,-4896.0
2001-05-29,24390,23880,-510,-1,510.0,-4386.0
2001-05-30,23880,23880,0,-1,-0.0,-4386.0
2001-05-31,23880,24798,918,1,918.0,-3468.0
2001-06-01,24798,24798,0,-1,-0.0,-3468.0
2001-06-02,24798,24798,0,1,0.0,-3468.0
2001-06-03,24798,24186,-612,-1,612.0,-2856.0
2001-06-04,24186,21583,-2603,1,-2603.0,-5459.0
2001-06-05,21583,21583,0,1,0.0,-5459.0
2001-06-06,21583,22655,1072,-1,-1072.0,-6531.0
2001-06-07,22655,26023,3368,-1,-3368.0,-9899.0
2001-06-08,26023,26023,0,0,0.0,-9899.0
2001-06-09,26023,26023,0,1,0.0,-9899.0
2001-06-10,26023,27859,1836,1,1836.0,-8063.0
2001-06-11,27859,27961,102,1,102.0,-7961.0
2001-06-12,27961,27553,-408,1,-408.0,-8369.0
2001-06-13,27553,27655,102,0,0.0,-8369.0
2001-06-14,27655,27553,-102,0,-0.0,-8369.0
2001-06-15,27553,27553,0,0,0.0,-8369.0
2001-06-16,27553,27553,0,1,0.0,-8369.0
2001-06-17,27553,27349,-204,0,-0.0,-8369.0
2001-06-18,27349,28982,1633,0,0.0,-8369.0
2001-06-19,28982,28064,-918,0,-0.0,-8369.0
2001-06-20,28064,28574,510,0,0.0,-8369.0
2001-06-21,28574,27349,-1225,-1,1225.0,-7144.0
2001-06-22,27349,27349,0,1,0.0,-7144.0
2001-06-23,27349,27349,0,0,0.0,-7144.0
2001-06-24,27349,26533,-816,-1,816.0,-6328.0
2001-06-25,26533,25512,-1021,-1,1021.0,-5307.0
2001-06-26,25512,25512,0,1,0.0,-5307.0
2001-06-27,25512,25002,-510,1,-510.0,-5817.0
2001-06-28,25002,25053,51,-1,-51.0,-5868.0
2001-06-29,25053,25053,0,1,0.0,-5868.0
2001-06-30,25053,25053,0,0,0.0,-5868.0
2001-07-01,25053,23471,-1582,0,-0.0,-5868.0
2001-07-02,23471,22859,-612,1,-612.0,-6480.0
2001-07-03,22859,25308,2449,-1,-2449.0,-8929.0
2001-07-04,25308,25104,-204,1,-204.0,-9133.0
2001-07-05,25104,24033,-1071,1,-1071.0,-10204.0
2001-07-06,24033,24033,0,1,0.0,-10204.0
2001-07-07,24033,24033,0,-1,-0.0,-10204.0
2001-07-08,24033,23675,-358,-1,358.0,-9846.0
2001-07-09,23675,22655,-1020,1,-1020.0,-10866.0
2001-07-10,22655,22196,-459,1,-459.0,-11325.0
2001-07-11,22196,22757,561,0,0.0,-11325.0
2001-07-12,22757,22145,-612,1,-612.0,-11937.0
2001-07-13,22145,22145,0,0,0.0,-11937.0
2001-07-14,22145,22145,0,0,0.0,-11937.0
2001-07-15,22145,21788,-357,-1,357.0,-11580.0
2001-07-16,21788,21788,0,1,0.0,-11580.0
2001-07-17,21788,21022,-766,1,-766.0,-12346.0
2001-07-18,21022,20920,-102,0,-0.0,-12346.0
2001-07-19,20920,19593,-1327,-1,1327.0,-11019.0
2001-07-20,19593,19593,0,-1,-0.0,-11019.0
2001-07-21,19593,19593,0,-1,-0.0,-11019.0
2001-07-22,19593,19083,-510,-1,510.0,-10509.0
2001-07-23,19083,18165,-918,0,-0.0,-10509.0
2001-07-24,18165,17961,-204,-1,204.0,-10305.0
2001-07-25,17961,17910,-51,1,-51.0,-10356.0
2001-07-26,17910,19083,1173,1,1173.0,-9183.0
2001-07-27,19083,19083,0,0,0.0,-9183.0
2001-07-28,19083,19083,0,1,0.0,-9183.0
2001-07-29,19083,18165,-918,0,-0.0,-9183.0
2001-07-30,18165,18573,408,1,408.0,-8775.0
2001-07-31,18573,19389,816,0,0.0,-8775.0
2001-08-01,19389,19083,-306,0,-0.0,-8775.0
2001-08-02,19083,19287,204,1,204.0,-8571.0
2001-08-03,19287,19287,0,-1,-0.0,-8571.0
2001-08-04,19287,19287,0,1,0.0,-8571.0
2001-08-05,19287,19287,0,0,0.0,-8571.0
2001-08-06,19287,18930,-357,1,-357.0,-8928.0
2001-08-07,18930,19083,153,-1,-153.0,-9081.0
2001-08-08,19083,18165,-918,0,-0.0,-9081.0
2001-08-09,18165,18114,-51,1,-51.0,-9132.0
2001-08-10,18114,18114,0,-1,-0.0,-9132.0
2001-08-11,18114,18114,0,0,0.0,-9132.0
2001-08-12,18114,18318,204,1,204.0,-8928.0
2001-08-13,18318,18675,357,1,357.0,-8571.0
2001-08-14,18675,18675,0,1,0.0,-8571.0
2001-08-15,18675,18573,-102,1,-102.0,-8673.0
2001-08-16,18573,18777,204,1,204.0,-8469.0
2001-08-17,18777,18777,0,-1,-0.0,-8469.0
2001-08-18,18777,18777,0,-1,-0.0,-8469.0
2001-08-19,18777,18063,-714,1,-714.0,-9183.0
2001-08-20,18063,17961,-102,1,-102.0,-9285.0
2001-08-21,17961,17552,-409,0,-0.0,-9285.0
2001-08-22,17552,17757,205,1,205.0,-9080.0
2001-08-23,17757,17501,-256,0,-0.0,-9080.0
2001-08-24,17501,17501,0,-1,-0.0,-9080.0
2001-08-25,17501,17501,0,-1,-0.0,-9080.0
2001-08-26,17501,17808,307,-1,-307.0,-9387.0
2001-08-27,17808,18420,612,0,0.0,-9387.0
2001-08-28,18420,18267,-153,1,-153.0,-9540.0
2001-08-29,18267,19083,816,-1,-816.0,-10356.0
2001-08-30,19083,18216,-867,1,-867.0,-11223.0
2001-08-31,18216,18216,0,1,0.0,-11223.0
2001-09-01,18216,18216,0,0,0.0,-11223.0
2001-09-02,18216,17552,-664,0,-0.0,-11223.0
2001-09-03,17552,18063,511,-1,-511.0,-11734.0
2001-09-04,18063,17808,-255,1,-255.0,-11989.0
2001-09-05,17808,17961,153,-1,-153.0,-12142.0
2001-09-06,17961,17961,0,1,0.0,-12142.0
2001-09-07,17961,17961,0,0,0.0,-12142.0
2001-09-08,17961,17961,0,0,0.0,-12142.0
2001-09-09,17961,17603,-358,1,-358.0,-12500.0
2001-09-10,17603,17195,-408,0,-0.0,-12500.0
2001-09-11,17195,14644,-2551,0,-0.0,-12500.0
2001-09-12,14644,14542,-102,-1,102.0,-12398.0
2001-09-13,14542,13164,-1378,-1,1378.0,-11020.0
2001-09-14,13164,13164,0,0,0.0,-11020.0
2001-09-15,13164,13164,0,1,0.0,-11020.0
2001-09-16,13164,12246,-918,1,-918.0,-11938.0
2001-09-17,12246,12705,459,0,0.0,-11938.0
2001-09-18,12705,13266,561,0,0.0,-11938.0
2001-09-19,13266,13266,0,-1,-0.0,-11938.0
2001-09-20,13266,13624,358,0,0.0,-11938.0
2001-09-21,13624,13624,0,0,0.0,-11938.0
2001-09-22,13624,13624,0,-1,-0.0,-11938.0
2001-09-23,13624,13777,153,1,153.0,-11785.0
2001-09-24,13777,13573,-204,1,-204.0,-11989.0
2001-09-25,13573,14185,612,1,612.0,-11377.0
2001-09-26,14185,14185,0,1,0.0,-11377.0
2001-09-27,14185,14797,612,0,0.0,-11377.0
2001-09-28,14797,14797,0,0,0.0,-11377.0
2001-09-29,14797,14797,0,0,0.0,-11377.0
2001-09-30,14797,14797,0,0,0.0,-11377.0
2001-10-01,14797,14797,0,1,0.0,-11377.0
2001-10-02,14797,14797,0,1,0.0,-11377.0
2001-10-03,14797,15563,766,0,0.0,-11377.0
2001-10-04,15563,15307,-256,1,-256.0,-11633.0
2001-10-05,15307,15307,0,-1,-0.0,-11633.0
2001-10-06,15307,15307,0,-1,-0.0,-11633.0
2001-10-07,15307,15307,0,-1,-0.0,-11633.0
2001-10-08,15307,15614,307,-1,-307.0,-11940.0
2001-10-09,15614,15307,-307,1,-307.0,-12247.0
2001-10-10,15307,15614,307,1,307.0,-11940.0
2001-10-11,15614,15563,-51,1,-51.0,-11991.0
2001-10-12,15563,15563,0,-1,-0.0,-11991.0
2001-10-13,15563,15563,0,0,0.0,-11991.0
2001-10-14,15563,15767,204,-1,-204.0,-12195.0
2001-10-15,15767,15716,-51,1,-51.0,-12246.0
2001-10-16,15716,15716,0,1,0.0,-12246.0
2001-10-17,15716,15460,-256,-1,256.0,-11990.0
2001-10-18,15460,15409,-51,0,-0.0,-11990.0
2001-10-19,15409,15409,0,-1,-0.0,-11990.0
2001-10-20,15409,15409,0,-1,-0.0,-11990.0
2001-10-21,15409,15460,51,-1,-51.0,-12041.0
2001-10-22,15460,15767,307,-1,-307.0,-12348.0
2001-10-23,15767,15767,0,-1,-0.0,-12348.0
2001-10-24,15767,15563,-204,0,-0.0,-12348.0
2001-10-25,15563,15563,0,0,0.0,-12348.0
2001-10-26,15563,15563,0,1,0.0,-12348.0
2001-10-27,15563,15563,0,-1,-0.0,-12348.0
2001-10-28,15563,15563,0,-1,-0.0,-12348.0
2001-10-29,15563,15154,-409,-1,409.0,-11939.0
2001-10-30,15154,15052,-102,-1,102.0,-11837.0
2001-10-31,15052,15307,255,0,0.0,-11837.0
2001-11-01,15307,15358,51,-1,-51.0,-11888.0
2001-11-02,15358,15358,0,-1,-0.0,-11888.0
2001-11-03,15358,15358,0,0,0.0,-11888.0
2001-11-04,15358,15511,153,0,0.0,-11888.0
2001-11-05,15511,15716,205,0,0.0,-11888.0
2001-11-06,15716,16634,918,0,0.0,-11888.0
2001-11-07,16634,17655,1021,1,1021.0,-10867.0
2001-11-08,17655,17552,-103,0,-0.0,-10867.0
2001-11-09,17552,17552,0,-1,-0.0,-10867.0
2001-11-10,17552,17552,0,1,0.0,-10867.0
2001-11-11,17552,17757,205,-1,-205.0,-11072.0
2001-11-12,17757,17552,-205,1,-205.0,-11277.0
2001-11-13,17552,17399,-153,-1,153.0,-11124.0
2001-11-14,17399,18165,766,1,766.0,-10358.0
2001-11-15,18165,20308,2143,0,0.0,-10358.0
2001-11-16,20308,20308,0,1,0.0,-10358.0
2001-11-17,20308,20308,0,-1,-0.0,-10358.0
2001-11-18,20308,20002,-306,1,-306.0,-10664.0
2001-11-19,20002,19900,-102,0,-0.0,-10664.0
2001-11-20,19900,20104,204,1,204.0,-10460.0
2001-11-21,20104,20614,510,-1,-510.0,-10970.0
2001-11-22,20614,20767,153,0,0.0,-10970.0
2001-11-23,20767,20767,0,0,0.0,-10970.0
2001-11-24,20767,20767,0,-1,-0.0,-10970.0
2001-11-25,20767,20512,-255,-1,255.0,-10715.0
2001-11-26,20512,20308,-204,-1,204.0,-10511.0
2001-11-27,20308,19389,-919,-1,919.0,-9592.0
2001-11-28,19389,19491,102,1,102.0,-9490.0
2001-11-29,19491,20104,613,0,0.0,-9490.0
2001-11-30,20104,20104,0,0,0.0,-9490.0
2001-12-01,20104,20104,0,-1,-0.0,-9490.0
2001-12-02,20104,20410,306,0,0.0,-9490.0
2001-12-03,20410,20410,0,-1,-0.0,-9490.0
2001-12-04,20410,21226,816,-1,-816.0,-10306.0
2001-12-05,21226,21736,510,-1,-510.0,-10816.0
2001-12-06,21736,22349,613,1,613.0,-10203.0
2001-12-07,22349,22349,0,-1,-0.0,-10203.0
2001-12-08,22349,22349,0,-1,-0.0,-10203.0
2001-12-09,22349,21634,-715,0,-0.0,-10203.0
2001-12-10,21634,20716,-918,1,-918.0,-11121.0
2001-12-11,20716,21022,306,0,0.0,-11121.0
2001-12-12,21022,20614,-408,0,-0.0,-11121.0
2001-12-13,20614,20614,0,-1,-0.0,-11121.0
2001-12-14,20614,20614,0,-1,-0.0,-11121.0
2001-12-15,20614,20614,0,1,0.0,-11121.0
2001-12-16,20614,20104,-510,1,-510.0,-11631.0
2001-12-17,20104,19389,-715,0,-0.0,-11631.0
2001-12-18,19389,19287,-102,1,-102.0,-11733.0
2001-12-19,19287,19849,562,0,0.0,-11733.0
2001-12-20,19849,19491,-358,0,-0.0,-11733.0
2001-12-21,19491,19491,0,-1,-0.0,-11733.0
2001-12-22,19491,19491,0,1,0.0,-11733.0
2001-12-23,19491,19491,0,0,0.0,-11733.0
2001-12-24,19491,19491,0,-1,-0.0,-11733.0
2001-12-25,19491,18981,-510,1,-510.0,-12243.0
2001-12-26,18981,19032,51,-1,-51.0,-12294.0
2001-12-27,19032,20053,1021,-1,-1021.0,-13315.0
2001-12-28,20053,20053,0,0,0.0,-13315.0
2001-12-29,20053,20053,0,0,0.0,-13315.0
2001-12-30,20053,20053,0,-1,-0.0,-13315.0
2001-12-31,20053,20053,0,1,0.0,-13315.0
2002-01-01,20053,19747,-306,-1,306.0,-13009.0
2002-01-02,19747,20920,1173,-1,-1173.0,-14182.0
2002-01-03,20920,21022,102,1,102.0,-14080.0
2002-01-04,21022,21022,0,0,0.0,-14080.0
2002-01-05,21022,21022,0,0,0.0,-14080.0
2002-01-06,21022,22145,1123,1,1123.0,-12957.0
2002-01-07,22145,20665,-1480,0,-0.0,-12957.0
2002-01-08,20665,20410,-255,0,-0.0,-12957.0
2002-01-09,20410,19798,-612,-1,612.0,-12345.0
2002-01-10,19798,19389,-409,0,-0.0,-12345.0
2002-01-11,19389,19389,0,-1,-0.0,-12345.0
2002-01-12,19389,19389,0,1,0.0,-12345.0
2002-01-13,19389,19440,51,0,0.0,-12345.0
2002-01-14,19440,18879,-561,-1,561.0,-11784.0
2002-01-15,18879,18573,-306,-1,306.0,-11478.0
2002-01-16,18573,18777,204,1,204.0,-11274.0
2002-01-17,18777,18471,-306,1,-306.0,-11580.0
2002-01-18,18471,18471,0,1,0.0,-11580.0
2002-01-19,18471,18471,0,1,0.0,-11580.0
2002-01-20,18471,19134,663,0,0.0,-11580.0
2002-01-21,19134,19032,-102,-1,102.0,-11478.0
2002-01-22,19032,19900,868,1,868.0,-10610.0
2002-01-23,19900,21175,1275,0,0.0,-10610.0
2002-01-24,21175,21328,153,0,0.0,-10610.0
2002-01-25,21328,21328,0,0,0.0,-10610.0
2002-01-26,21328,21328,0,1,0.0,-10610.0
2002-01-27,21328,21430,102,-1,-102.0,-10712.0
2002-01-28,21430,23675,2245,1,2245.0,-8467.0
2002-01-29,23675,22145,-1530,1,-1530.0,-9997.0
2002-01-30,22145,22859,714,-1,-714.0,-10711.0
2002-01-31,22859,23267,408,0,0.0,-10711.0
2002-02-01,23267,23267,0,1,0.0,-10711.0
2002-02-02,23267,23267,0,1,0.0,-10711.0
2002-02-03,23267,21481,-1786,-1,1786.0,-8925.0
2002-02-04,21481,21430,-51,1,-51.0,-8976.0
2002-02-05,21430,21634,204,0,0.0,-8976.0
2002-02-06,21634,21226,-408,0,-0.0,-8976.0
2002-02-07,21226,21890,664,0,0.0,-8976.0
2002-02-08,21890,21890,0,1,0.0,-8976.0
2002-02-09,21890,21890,0,1,0.0,-8976.0
2002-02-10,21890,21890,0,-1,-0.0,-8976.0
2002-02-11,21890,21890,0,1,0.0,-8976.0
2002-02-12,21890,21890,0,-1,-0.0,-8976.0
2002-02-13,21890,22451,561,0,0.0,-8976.0
2002-02-14,22451,23063,612,1,612.0,-8364.0
2002-02-15,23063,23063,0,1,0.0,-8364.0
2002-02-16,23063,23063,0,-1,-0.0,-8364.0
2002-02-17,23063,23777,714,-1,-714.0,-9078.0
2002-02-18,23777,23522,-255,-1,255.0,-8823.0
2002-02-19,23522,24441,919,-1,-919.0,-9742.0
2002-02-20,24441,24543,102,0,0.0,-9742.0
2002-02-21,24543,24900,357,0,0.0,-9742.0
2002-02-22,24900,24900,0,-1,-0.0,-9742.0
2002-02-23,24900,24900,0,-1,-0.0,-9742.0
2002-02-24,24900,23880,-1020,1,-1020.0,-10762.0
2002-02-25,23880,23777,-103,-1,103.0,-10659.0
2002-02-26,23777,23777,0,0,0.0,-10659.0
2002-02-27,23777,24339,562,-1,-562.0,-11221.0
2002-02-28,24339,24339,0,1,0.0,-11221.0
2002-03-01,24339,24339,0,-1,-0.0,-11221.0
2002-03-02,24339,24339,0,0,0.0,-11221.0
2002-03-03,24339,23777,-562,1,-562.0,-11783.0
2002-03-04,23777,23369,-408,1,-408.0,-12191.0
2002-03-05,23369,25002,1633,-1,-1633.0,-13824.0
2002-03-06,25002,25002,0,0,0.0,-13824.0
2002-03-07,25002,25053,51,0,0.0,-13824.0
2002-03-08,25053,25053,0,-1,-0.0,-13824.0
2002-03-09,25053,25053,0,-1,-0.0,-13824.0
2002-03-10,25053,24798,-255,0,-0.0,-13824.0
2002-03-11,24798,25206,408,0,0.0,-13824.0
2002-03-12,25206,25257,51,-1,-51.0,-13875.0
2002-03-13,25257,24951,-306,-1,306.0,-13569.0
2002-03-14,24951,25002,51,1,51.0,-13518.0
2002-03-15,25002,25002,0,-1,-0.0,-13518.0
2002-03-16,25002,25002,0,-1,-0.0,-13518.0
2002-03-17,25002,25104,102,1,102.0,-13416.0
2002-03-18,25104,26533,1429,-1,-1429.0,-14845.0
2002-03-19,26533,26737,204,0,0.0,-14845.0
2002-03-20,26737,27043,306,0,0.0,-14845.0
2002-03-21,27043,27043,0,0,0.0,-14845.0
2002-03-22,27043,27043,0,-1,-0.0,-14845.0
2002-03-23,27043,27043,0,1,0.0,-14845.0
2002-03-24,27043,26227,-816,-1,816.0,-14029.0
2002-03-25,26227,25972,-255,1,-255.0,-14284.0
2002-03-26,25972,26941,969,0,0.0,-14284.0
2002-03-27,26941,27451,510,0,0.0,-14284.0
2002-03-28,27451,27043,-408,0,-0.0,-14284.0
2002-03-29,27043,27043,0,1,0.0,-14284.0
2002-03-30,27043,27043,0,-1,-0.0,-14284.0
2002-03-31,27043,25053,-1990,-1,1990.0,-12294.0
2002-04-01,25053,26686,1633,-1,-1633.0,-13927.0
2002-04-02,26686,26431,-255,-1,255.0,-13672.0
2002-04-03,26431,26023,-408,0,-0.0,-13672.0
2002-04-04,26023,26023,0,0,0.0,-13672.0
2002-04-05,26023,26023,0,-1,-0.0,-13672.0
2002-04-06,26023,26023,0,-1,-0.0,-13672.0
2002-04-07,26023,25308,-715,0,-0.0,-13672.0
2002-04-08,25308,25512,204,1,204.0,-13468.0
2002-04-09,25512,24492,-1020,1,-1020.0,-14488.0
2002-04-10,24492,24390,-102,-1,102.0,-14386.0
2002-04-11,24390,24033,-357,1,-357.0,-14743.0
2002-04-12,24033,24033,0,0,0.0,-14743.0
2002-04-13,24033,24033,0,1,0.0,-14743.0
2002-04-14,24033,24543,510,0,0.0,-14743.0
2002-04-15,24543,24645,102,-1,-102.0,-14845.0
2002-04-16,24645,25002,357,0,0.0,-14845.0
2002-04-17,25002,25614,612,0,0.0,-14845.0
2002-04-18,25614,24951,-663,0,-0.0,-14845.0
2002-04-19,24951,24951,0,-1,-0.0,-14845.0
2002-04-20,24951,24951,0,0,0.0,-14845.0
2002-04-21,24951,23982,-969,1,-969.0,-15814.0
2002-04-22,23982,23012,-970,1,-970.0,-16784.0
2002-04-23,23012,22349,-663,0,-0.0,-16784.0
2002-04-24,22349,21124,-1225,-1,1225.0,-15559.0
2002-04-25,21124,21430,306,0,0.0,-15559.0
2002-04-26,21430,21430,0,0,0.0,-15559.0
2002-04-27,21430,21430,0,0,0.0,-15559.0
2002-04-28,21430,20512,-918,0,-0.0,-15559.0
2002-04-29,20512,21532,1020,0,0.0,-15559.0
2002-04-30,21532,21532,0,0,0.0,-15559.0
2002-05-01,21532,21736,204,-1,-204.0,-15763.0
2002-05-02,21736,22145,409,0,0.0,-15763.0
2002-05-03,22145,22145,0,-1,-0.0,-15763.0
2002-05-04,22145,22145,0,0,0.0,-15763.0
2002-05-05,22145,21022,-1123,-1,1123.0,-14640.0
2002-05-06,21022,21634,612,1,612.0,-14028.0
2002-05-07,21634,21736,102,1,102.0,-13926.0
2002-05-08,21736,21379,-357,0,-0.0,-13926.0
2002-05-09,21379,21430,51,0,0.0,-13926.0
2002-05-10,21430,21430,0,-1,-0.0,-13926.0
2002-05-11,21430,21430,0,1,0.0,-13926.0
2002-05-12,21430,21685,255,1,255.0,-13671.0
2002-05-13,21685,22094,409,-1,-409.0,-14080.0
2002-05-14,22094,22247,153,0,0.0,-14080.0
2002-05-15,22247,21481,-766,0,-0.0,-14080.0
2002-05-16,21481,21532,51,-1,-51.0,-14131.0
2002-05-17,21532,21532,0,0,0.0,-14131.0
2002-05-18,21532,21532,0,1,0.0,-14131.0
2002-05-19,21532,20920,-612,-1,612.0,-13519.0
2002-05-20,20920,20308,-612,0,-0.0,-13519.0
2002-05-21,20308,20002,-306,-1,306.0,-13213.0
2002-05-22,20002,18828,-1174,0,-0.0,-13213.0
2002-05-23,18828,19032,204,1,204.0,-13009.0
2002-05-24,19032,19032,0,0,0.0,-13009.0
2002-05-25,19032,19032,0,0,0.0,-13009.0
2002-05-26,19032,18165,-867,1,-867.0,-13876.0
2002-05-27,18165,18114,-51,0,-0.0,-13876.0
2002-05-28,18114,17859,-255,1,-255.0,-14131.0
2002-05-29,17859,17450,-409,-1,409.0,-13722.0
2002-05-30,17450,18930,1480,0,0.0,-13722.0
2002-05-31,18930,18930,0,0,0.0,-13722.0
2002-06-01,18930,18930,0,0,0.0,-13722.0
2002-06-02,18930,18369,-561,0,-0.0,-13722.0
2002-06-03,18369,17859,-510,0,-0.0,-13722.0
2002-06-04,17859,18165,306,-1,-306.0,-14028.0
2002-06-05,18165,18165,0,1,0.0,-14028.0
2002-06-06,18165,17603,-562,-1,562.0,-13466.0
2002-06-07,17603,17603,0,1,0.0,-13466.0
2002-06-08,17603,17603,0,0,0.0,-13466.0
2002-06-09,17603,17757,154,0,0.0,-13466.0
2002-06-10,17757,18777,1020,0,0.0,-13466.0
2002-06-11,18777,18624,-153,0,-0.0,-13466.0
2002-06-12,18624,18624,0,0,0.0,-13466.0
2002-06-13,18624,18726,102,1,102.0,-13364.0
2002-06-14,18726,18726,0,0,0.0,-13364.0
2002-06-15,18726,18726,0,1,0.0,-13364.0
2002-06-16,18726,19389,663,0,0.0,-13364.0
2002-06-17,19389,19185,-204,-1,204.0,-13160.0
2002-06-18,19185,17552,-1633,0,-0.0,-13160.0
2002-06-19,17552,17808,256,1,256.0,-12904.0
2002-06-20,17808,17706,-102,0,-0.0,-12904.0
2002-06-21,17706,17706,0,1,0.0,-12904.0
2002-06-22,17706,17706,0,-1,-0.0,-12904.0
2002-06-23,17706,17042,-664,-1,664.0,-12240.0
2002-06-24,17042,16838,-204,-1,204.0,-12036.0
2002-06-25,16838,15256,-1582,0,-0.0,-12036.0
2002-06-26,15256,15205,-51,1,-51.0,-12087.0
2002-06-27,15205,16277,1072,0,0.0,-12087.0
2002-06-28,16277,16277,0,-1,-0.0,-12087.0
2002-06-29,16277,16277,0,0,0.0,-12087.0
2002-06-30,16277,16277,0,0,0.0,-12087.0
2002-07-01,16277,16022,-255,-1,255.0,-11832.0
2002-07-02,16022,16022,0,1,0.0,-11832.0
2002-07-03,16022,16838,816,-1,-816.0,-12648.0
2002-07-04,16838,16736,-102,1,-102.0,-12750.0
2002-07-05,16736,16736,0,1,0.0,-12750.0
2002-07-06,16736,16736,0,-1,-0.0,-12750.0
2002-07-07,16736,16430,-306,-1,306.0,-12444.0
2002-07-08,16430,17552,1122,1,1122.0,-11322.0
2002-07-09,17552,17961,409,-1,-409.0,-11731.0
2002-07-10,17961,17348,-613,0,-0.0,-11731.0
2002-07-11,17348,17808,460,0,0.0,-11731.0
2002-07-12,17808,17808,0,1,0.0,-11731.0
2002-07-13,17808,17808,0,1,0.0,-11731.0
2002-07-14,17808,17195,-613,0,-0.0,-11731.0
2002-07-15,17195,16532,-663,-1,663.0,-11068.0
2002-07-16,16532,16532,0,1,0.0,-11068.0
2002-07-17,16532,16634,102,0,0.0,-11068.0
2002-07-18,16634,15920,-714,1,-714.0,-11782.0
2002-07-19,15920,15920,0,0,0.0,-11782.0
2002-07-20,15920,15920,0,-1,-0.0,-11782.0
2002-07-21,15920,15052,-868,0,-0.0,-11782.0
2002-07-22,15052,15460,408,-1,-408.0,-12190.0
2002-07-23,15460,15358,-102,-1,102.0,-12088.0
2002-07-24,15358,15511,153,-1,-153.0,-12241.0
2002-07-25,15511,15001,-510,-1,510.0,-11731.0
2002-07-26,15001,15001,0,0,0.0,-11731.0
2002-07-27,15001,15001,0,1,0.0,-11731.0
2002-07-28,15001,14950,-51,1,-51.0,-11782.0
2002-07-29,14950,15460,510,-1,-510.0,-12292.0
2002-07-30,15460,15307,-153,1,-153.0,-12445.0
2002-07-31,15307,15154,-153,1,-153.0,-12598.0
2002-08-01,15154,15052,-102,1,-102.0,-12700.0
2002-08-02,15052,15052,0,1,0.0,-12700.0
2002-08-03,15052,15052,0,1,0.0,-12700.0
2002-08-04,15052,14746,-306,-1,306.0,-12394.0
2002-08-05,14746,15103,357,-1,-357.0,-12751.0
2002-08-06,15103,14899,-204,1,-204.0,-12955.0
2002-08-07,14899,14695,-204,1,-204.0,-13159.0
2002-08-08,14695,15307,612,-1,-612.0,-13771.0
2002-08-09,15307,15307,0,0,0.0,-13771.0
2002-08-10,15307,15307,0,-1,-0.0,-13771.0
2002-08-11,15307,15205,-102,0,-0.0,-13771.0
2002-08-12,15205,15460,255,-1,-255.0,-14026.0
2002-08-13,15460,15460,0,0,0.0,-14026.0
2002-08-14,15460,15460,0,0,0.0,-14026.0
2002-08-15,15460,15307,-153,-1,153.0,-13873.0
2002-08-16,15307,15307,0,-1,-0.0,-13873.0
2002-08-17,15307,15307,0,-1,-0.0,-13873.0
2002-08-18,15307,14287,-1020,0,-0.0,-13873.0
2002-08-19,14287,14287,0,0,0.0,-13873.0
2002-08-20,14287,14644,357,1,357.0,-13516.0
2002-08-21,14644,14644,0,-1,-0.0,-13516.0
2002-08-22,14644,14593,-51,1,-51.0,-13567.0
2002-08-23,14593,14593,0,1,0.0,-13567.0
2002-08-24,14593,14593,0,1,0.0,-13567.0
2002-08-25,14593,14542,-51,0,-0.0,-13567.0
2002-08-26,14542,14287,-255,0,-0.0,-13567.0
2002-08-27,14287,14236,-51,0,-0.0,-13567.0
2002-08-28,14236,14287,51,0,0.0,-13567.0
2002-08-29,14287,14185,-102,-1,102.0,-13465.0
2002-08-30,14185,14185,0,-1,-0.0,-13465.0
2002-08-31,14185,14185,0,-1,-0.0,-13465.0
2002-09-01,14185,14746,561,0,0.0,-13465.0
2002-09-02,14746,14797,51,-1,-51.0,-13516.0
2002-09-03,14797,14542,-255,-1,255.0,-13261.0
2002-09-04,14542,14491,-51,0,-0.0,-13261.0
2002-09-05,14491,14236,-255,1,-255.0,-13516.0
2002-09-06,14236,14236,0,1,0.0,-13516.0
2002-09-07,14236,14236,0,1,0.0,-13516.0
2002-09-08,14236,14083,-153,1,-153.0,-13669.0
2002-09-09,14083,13930,-153,1,-153.0,-13822.0
2002-09-10,13930,14644,714,0,0.0,-13822.0
2002-09-11,14644,14593,-51,1,-51.0,-13873.0
2002-09-12,14593,14389,-204,1,-204.0,-14077.0
2002-09-13,14389,14389,0,0,0.0,-14077.0
2002-09-14,14389,14389,0,-1,-0.0,-14077.0
2002-09-15,14389,13930,-459,-1,459.0,-13618.0
2002-09-16,13930,14083,153,1,153.0,-13465.0
2002-09-17,14083,13368,-715,-1,715.0,-12750.0
2002-09-18,13368,13266,-102,-1,102.0,-12648.0
2002-09-19,13266,13266,0,-1,-0.0,-12648.0
2002-09-20,13266,13266,0,0,0.0,-12648.0
2002-09-21,13266,13266,0,1,0.0,-12648.0
2002-09-22,13266,12705,-561,0,-0.0,-12648.0
2002-09-23,12705,12042,-663,0,-0.0,-12648.0
2002-09-24,12042,11532,-510,1,-510.0,-13158.0
2002-09-25,11532,11378,-154,1,-154.0,-13312.0
2002-09-26,11378,11327,-51,1,-51.0,-13363.0
2002-09-27,11327,11327,0,0,0.0,-13363.0
2002-09-28,11327,11327,0,0,0.0,-13363.0
2002-09-29,11327,10511,-816,1,-816.0,-14179.0
2002-09-30,10511,10817,306,1,306.0,-13873.0
2002-10-01,10817,10409,-408,0,-0.0,-13873.0
2002-10-02,10409,10409,0,0,0.0,-13873.0
2002-10-03,10409,10358,-51,1,-51.0,-13924.0
2002-10-04,10358,10358,0,1,0.0,-13924.0
2002-10-05,10358,10358,0,0,0.0,-13924.0
2002-10-06,10358,10062,-296,-1,296.0,-13628.0
2002-10-07,10062,10205,143,1,143.0,-13485.0
2002-10-08,10205,9991,-214,0,-0.0,-13485.0
2002-10-09,9991,9542,-449,1,-449.0,-13934.0
2002-10-10,9542,9133,-409,1,-409.0,-14343.0
2002-10-11,9133,9133,0,0,0.0,-14343.0
2002-10-12,9133,9133,0,1,0.0,-14343.0
2002-10-13,9133,9399,266,1,266.0,-14077.0
2002-10-14,9399,9695,296,0,0.0,-14077.0
2002-10-15,9695,9909,214,-1,-214.0,-14291.0
2002-10-16,9909,10001,92,0,0.0,-14291.0
2002-10-17,10001,11225,1224,-1,-1224.0,-15515.0
2002-10-18,11225,11225,0,0,0.0,-15515.0
2002-10-19,11225,11225,0,0,0.0,-15515.0
2002-10-20,11225,11072,-153,1,-153.0,-15668.0
2002-10-21,11072,10511,-561,1,-561.0,-16229.0
2002-10-22,10511,11021,510,1,510.0,-15719.0
2002-10-23,11021,10511,-510,0,-0.0,-15719.0
2002-10-24,10511,10715,204,0,0.0,-15719.0
2002-10-25,10715,10715,0,0,0.0,-15719.0
2002-10-26,10715,10715,0,1,0.0,-15719.0
2002-10-27,10715,10613,-102,-1,102.0,-15617.0
2002-10-28,10613,10613,0,1,0.0,-15617.0
2002-10-29,10613,10409,-204,1,-204.0,-15821.0
2002-10-30,10409,10409,0,1,0.0,-15821.0
2002-10-31,10409,10358,-51,1,-51.0,-15872.0
2002-11-01,10358,10358,0,0,0.0,-15872.0
2002-11-02,10358,10358,0,-1,-0.0,-15872.0
2002-11-03,10358,10766,408,-1,-408.0,-16280.0
2002-11-04,10766,10562,-204,1,-204.0,-16484.0
2002-11-05,10562,10613,51,-1,-51.0,-16535.0
2002-11-06,10613,10307,-306,-1,306.0,-16229.0
2002-11-07,10307,10103,-204,1,-204.0,-16433.0
2002-11-08,10103,10103,0,1,0.0,-16433.0
2002-11-09,10103,10103,0,1,0.0,-16433.0
2002-11-10,10103,9797,-306,1,-306.0,-16739.0
2002-11-11,9797,9776,-21,1,-21.0,-16760.0
2002-11-12,9776,9787,11,1,11.0,-16749.0
2002-11-13,9787,9950,163,1,163.0,-16586.0
2002-11-14,9950,10511,561,-1,-561.0,-17147.0
2002-11-15,10511,10511,0,-1,-0.0,-17147.0
2002-11-16,10511,10511,0,0,0.0,-17147.0
2002-11-17,10511,10562,51,1,51.0,-17096.0
2002-11-18,10562,10613,51,0,0.0,-17096.0
2002-11-19,10613,10664,51,-1,-51.0,-17147.0
2002-11-20,10664,10613,-51,0,-0.0,-17147.0
2002-11-21,10613,10562,-51,-1,51.0,-17096.0
2002-11-22,10562,10562,0,0,0.0,-17096.0
2002-11-23,10562,10562,0,0,0.0,-17096.0
2002-11-24,10562,10460,-102,0,-0.0,-17096.0
2002-11-25,10460,10613,153,-1,-153.0,-17249.0
2002-11-26,10613,11174,561,1,561.0,-16688.0
2002-11-27,11174,11634,460,1,460.0,-16228.0
2002-11-28,11634,11787,153,-1,-153.0,-16381.0
2002-11-29,11787,11787,0,-1,-0.0,-16381.0
2002-11-30,11787,11787,0,1,0.0,-16381.0
2002-12-01,11787,11787,0,1,0.0,-16381.0
2002-12-02,11787,11583,-204,0,-0.0,-16381.0
2002-12-03,11583,11174,-409,1,-409.0,-16790.0
2002-12-04,11174,11327,153,1,153.0,-16637.0
2002-12-05,11327,11276,-51,1,-51.0,-16688.0
2002-12-06,11276,11276,0,0,0.0,-16688.0
2002-12-07,11276,11276,0,-1,-0.0,-16688.0
2002-12-08,11276,11327,51,0,0.0,-16688.0
2002-12-09,11327,11378,51,0,0.0,-16688.0
2002-12-10,11378,11174,-204,-1,204.0,-16484.0
2002-12-11,11174,11225,51,-1,-51.0,-16535.0
2002-12-12,11225,11174,-51,0,-0.0,-16535.0
2002-12-13,11174,11174,0,1,0.0,-16535.0
2002-12-14,11174,11174,0,0,0.0,-16535.0
2002-12-15,11174,10766,-408,0,-0.0,-16535.0
2002-12-16,10766,11021,255,1,255.0,-16280.0
2002-12-17,11021,11072,51,0,0.0,-16280.0
2002-12-18,11072,11072,0,1,0.0,-16280.0
2002-12-19,11072,10868,-204,1,-204.0,-16484.0
2002-12-20,10868,10868,0,1,0.0,-16484.0
2002-12-21,10868,10868,0,0,0.0,-16484.0
2002-12-22,10868,10144,-724,1,-724.0,-17208.0
2002-12-23,10144,9674,-470,0,-0.0,-17208.0
2002-12-24,9674,9674,0,1,0.0,-17208.0
2002-12-25,9674,9317,-357,0,-0.0,-17208.0
2002-12-26,9317,9133,-184,-1,184.0,-17024.0
2002-12-27,9133,9133,0,1,0.0,-17024.0
2002-12-28,9133,9133,0,-1,-0.0,-17024.0
2002-12-29,9133,8980,-153,-1,153.0,-16871.0
2002-12-30,8980,8980,0,0,0.0,-16871.0
2002-12-31,8980,8980,0,0,0.0,-16871.0
2003-01-01,8980,9389,409,0,0.0,-16871.0
2003-01-02,9389,9695,306,0,0.0,-16871.0
2003-01-03,9695,9695,0,0,0.0,-16871.0
2003-01-04,9695,9695,0,1,0.0,-16871.0
2003-01-05,9695,9562,-133,-1,133.0,-16738.0
2003-01-06,9562,9695,133,-1,-133.0,-16871.0
2003-01-07,9695,9746,51,1,51.0,-16820.0
2003-01-08,9746,9674,-72,0,-0.0,-16820.0
2003-01-09,9674,9644,-30,-1,30.0,-16790.0
2003-01-10,9644,9644,0,0,0.0,-16790.0
2003-01-11,9644,9644,0,-1,-0.0,-16790.0
2003-01-12,9644,9705,61,1,61.0,-16729.0
2003-01-13,9705,9593,-112,-1,112.0,-16617.0
2003-01-14,9593,9409,-184,-1,184.0,-16433.0
2003-01-15,9409,9409,0,0,0.0,-16433.0
2003-01-16,9409,9235,-174,-1,174.0,-16259.0
2003-01-17,9235,9235,0,-1,-0.0,-16259.0
2003-01-18,9235,9235,0,1,0.0,-16259.0
2003-01-19,9235,9082,-153,0,-0.0,-16259.0
2003-01-20,9082,9164,82,-1,-82.0,-16341.0
2003-01-21,9164,8868,-296,1,-296.0,-16637.0
2003-01-22,8868,8929,61,1,61.0,-16576.0
2003-01-23,8929,8797,-132,1,-132.0,-16708.0
2003-01-24,8797,8797,0,1,0.0,-16708.0
2003-01-25,8797,8797,0,-1,-0.0,-16708.0
2003-01-26,8797,8317,-480,-1,480.0,-16228.0
2003-01-27,8317,8337,20,1,20.0,-16208.0
2003-01-28,8337,7858,-479,0,-0.0,-16208.0
2003-01-29,7858,8113,255,1,255.0,-15953.0
2003-01-30,8113,8113,0,-1,-0.0,-15953.0
2003-01-31,8113,8113,0,1,0.0,-15953.0
2003-02-01,8113,8113,0,0,0.0,-15953.0
2003-02-02,8113,8062,-51,-1,51.0,-15902.0
2003-02-03,8062,8062,0,1,0.0,-15902.0
2003-02-04,8062,8041,-21,-1,21.0,-15881.0
2003-02-05,8041,7858,-183,1,-183.0,-16064.0
2003-02-06,7858,7684,-174,0,-0.0,-16064.0
2003-02-07,7684,7684,0,0,0.0,-16064.0
2003-02-08,7684,7684,0,0,0.0,-16064.0
2003-02-09,7684,7623,-61,-1,61.0,-16003.0
2003-02-10,7623,7450,-173,-1,173.0,-15830.0
2003-02-11,7450,7552,102,-1,-102.0,-15932.0
2003-02-12,7552,7460,-92,0,-0.0,-15932.0
2003-02-13,7460,7480,20,-1,-20.0,-15952.0
2003-02-14,7480,7480,0,0,0.0,-15952.0
2003-02-15,7480,7480,0,-1,-0.0,-15952.0
2003-02-16,7480,7817,337,0,0.0,-15952.0
2003-02-17,7817,7756,-61,0,-0.0,-15952.0
2003-02-18,7756,7654,-102,-1,102.0,-15850.0
2003-02-19,7654,7582,-72,0,-0.0,-15850.0
2003-02-20,7582,7541,-41,-1,41.0,-15809.0
2003-02-21,7541,7541,0,1,0.0,-15809.0
2003-02-22,7541,7541,0,-1,-0.0,-15809.0
2003-02-23,7541,8664,1123,1,1123.0,-14686.0
2003-02-24,8664,8980,316,-1,-316.0,-15002.0
2003-02-25,8980,8409,-571,1,-571.0,-15573.0
2003-02-26,8409,8062,-347,1,-347.0,-15920.0
2003-02-27,8062,8154,92,-1,-92.0,-16012.0
2003-02-28,8154,8154,0,0,0.0,-16012.0
2003-03-01,8154,8154,0,0,0.0,-16012.0
2003-03-02,8154,8256,102,-1,-102.0,-16114.0
2003-03-03,8256,8001,-255,0,-0.0,-16114.0
2003-03-04,8001,7490,-511,0,-0.0,-16114.0
2003-03-05,7490,7429,-61,1,-61.0,-16175.0
2003-03-06,7429,7286,-143,-1,143.0,-16032.0
2003-03-07,7286,7286,0,-1,-0.0,-16032.0
2003-03-08,7286,7286,0,0,0.0,-16032.0
2003-03-09,7286,7133,-153,-1,153.0,-15879.0
2003-03-10,7133,6899,-234,-1,234.0,-15645.0
2003-03-11,6899,7143,244,0,0.0,-15645.0
2003-03-12,7143,7245,102,0,0.0,-15645.0
2003-03-13,7245,7245,0,0,0.0,-15645.0
2003-03-14,7245,7245,0,0,0.0,-15645.0
2003-03-15,7245,7245,0,0,0.0,-15645.0
2003-03-16,7245,6735,-510,0,-0.0,-15645.0
2003-03-17,6735,7052,317,0,0.0,-15645.0
2003-03-18,7052,7052,0,-1,-0.0,-15645.0
2003-03-19,7052,7460,408,0,0.0,-15645.0
2003-03-20,7460,7654,194,-1,-194.0,-15839.0
2003-03-21,7654,7654,0,-1,-0.0,-15839.0
2003-03-22,7654,7654,0,1,0.0,-15839.0
2003-03-23,7654,7552,-102,-1,102.0,-15737.0
2003-03-24,7552,7235,-317,1,-317.0,-16054.0
2003-03-25,7235,7245,10,-1,-10.0,-16064.0
2003-03-26,7245,7123,-122,-1,122.0,-15942.0
2003-03-27,7123,7419,296,0,0.0,-15942.0
2003-03-28,7419,7419,0,-1,-0.0,-15942.0
2003-03-29,7419,7419,0,-1,-0.0,-15942.0
2003-03-30,7419,7348,-71,-1,71.0,-15871.0
2003-03-31,7348,7174,-174,1,-174.0,-16045.0
2003-04-01,7174,7174,0,0,0.0,-16045.0
2003-04-02,7174,7143,-31,0,-0.0,-16045.0
2003-04-03,7143,7194,51,1,51.0,-15994.0
2003-04-04,7194,7194,0,-1,-0.0,-15994.0
2003-04-05,7194,7194,0,0,0.0,-15994.0
2003-04-06,7194,7480,286,-1,-286.0,-16280.0
2003-04-07,7480,7511,31,1,31.0,-16249.0
2003-04-08,7511,7307,-204,0,-0.0,-16249.0
2003-04-09,7307,7337,30,-1,-30.0,-16279.0
2003-04-10,7337,8399,1062,0,0.0,-16279.0
2003-04-11,8399,8399,0,0,0.0,-16279.0
2003-04-12,8399,8399,0,1,0.0,-16279.0
2003-04-13,8399,8399,0,-1,-0.0,-16279.0
2003-04-14,8399,8786,387,-1,-387.0,-16666.0
2003-04-15,8786,9286,500,-1,-500.0,-17166.0
2003-04-16,9286,9286,0,0,0.0,-17166.0
2003-04-17,9286,9286,0,0,0.0,-17166.0
2003-04-18,9286,9286,0,0,0.0,-17166.0
2003-04-19,9286,9286,0,1,0.0,-17166.0
2003-04-20,9286,8991,-295,1,-295.0,-17461.0
2003-04-21,8991,8521,-470,1,-470.0,-17931.0
2003-04-22,8521,8746,225,0,0.0,-17931.0
2003-04-23,8746,8929,183,1,183.0,-17748.0
2003-04-24,8929,8021,-908,-1,908.0,-16840.0
2003-04-25,8021,8021,0,0,0.0,-16840.0
2003-04-26,8021,8021,0,0,0.0,-16840.0
2003-04-27,8021,8062,41,0,0.0,-16840.0
2003-04-28,8062,8562,500,1,500.0,-16340.0
2003-04-29,8562,8460,-102,1,-102.0,-16442.0
2003-04-30,8460,8460,0,0,0.0,-16442.0
2003-05-01,8460,8419,-41,1,-41.0,-16483.0
2003-05-02,8419,8419,0,-1,-0.0,-16483.0
2003-05-03,8419,8419,0,1,0.0,-16483.0
2003-05-04,8419,8419,0,0,0.0,-16483.0
2003-05-05,8419,8266,-153,0,-0.0,-16483.0
2003-05-06,8266,8317,51,1,51.0,-16432.0
2003-05-07,8317,8317,0,1,0.0,-16432.0
2003-05-08,8317,8409,92,1,92.0,-16340.0
2003-05-09,8409,8409,0,1,0.0,-16340.0
2003-05-10,8409,8409,0,-1,-0.0,-16340.0
2003-05-11,8409,8929,520,0,0.0,-16340.0
2003-05-12,8929,8725,-204,1,-204.0,-16544.0
2003-05-13,8725,9031,306,-1,-306.0,-16850.0
2003-05-14,9031,10001,970,0,0.0,-16850.0
2003-05-15,10001,9235,-766,0,-0.0,-16850.0
2003-05-16,9235,9235,0,0,0.0,-16850.0
2003-05-17,9235,9235,0,-1,-0.0,-16850.0
2003-05-18,9235,8735,-500,1,-500.0,-17350.0
2003-05-19,8735,8888,153,0,0.0,-17350.0
2003-05-20,8888,9042,154,1,154.0,-17196.0
2003-05-21,9042,9082,40,0,0.0,-17196.0
2003-05-22,9082,9195,113,0,0.0,-17196.0
2003-05-23,9195,9195,0,-1,-0.0,-17196.0
2003-05-24,9195,9195,0,-1,-0.0,-17196.0
2003-05-25,9195,9521,326,-1,-326.0,-17522.0
2003-05-26,9521,9440,-81,0,-0.0,-17522.0
2003-05-27,9440,9562,122,1,122.0,-17400.0
2003-05-28,9562,9562,0,0,0.0,-17400.0
2003-05-29,9562,9184,-378,0,-0.0,-17400.0
2003-05-30,9184,9184,0,-1,-0.0,-17400.0
2003-05-31,9184,9184,0,1,0.0,-17400.0
2003-06-01,9184,9491,307,0,0.0,-17400.0
2003-06-02,9491,9491,0,-1,-0.0,-17400.0
2003-06-03,9491,9491,0,1,0.0,-17400.0
2003-06-04,9491,9593,102,-1,-102.0,-17502.0
2003-06-05,9593,9593,0,1,0.0,-17502.0
2003-06-06,9593,9593,0,1,0.0,-17502.0
2003-06-07,9593,9593,0,-1,-0.0,-17502.0
2003-06-08,9593,9593,0,0,0.0,-17502.0
2003-06-09,9593,9480,-113,0,-0.0,-17502.0
2003-06-10,9480,9491,11,1,11.0,-17491.0
2003-06-11,9491,9429,-62,0,-0.0,-17491.0
2003-06-12,9429,9389,-40,0,-0.0,-17491.0
2003-06-13,9389,9389,0,1,0.0,-17491.0
2003-06-14,9389,9389,0,-1,-0.0,-17491.0
2003-06-15,9389,9184,-205,1,-205.0,-17696.0
2003-06-16,9184,9338,154,0,0.0,-17696.0
2003-06-17,9338,9338,0,1,0.0,-17696.0
2003-06-18,9338,9756,418,1,418.0,-17278.0
2003-06-19,9756,10460,704,-1,-704.0,-17982.0
2003-06-20,10460,10460,0,1,0.0,-17982.0
2003-06-21,10460,10460,0,-1,-0.0,-17982.0
2003-06-22,10460,10460,0,-1,-0.0,-17982.0
2003-06-23,10460,10185,-275,1,-275.0,-18257.0
2003-06-24,10185,10511,326,0,0.0,-18257.0
2003-06-25,10511,9899,-612,1,-612.0,-18869.0
2003-06-26,9899,9848,-51,0,-0.0,-18869.0
2003-06-27,9848,9848,0,0,0.0,-18869.0
2003-06-28,9848,9848,0,1,0.0,-18869.0
2003-06-29,9848,9695,-153,-1,153.0,-18716.0
2003-06-30,9695,9715,20,0,0.0,-18716.0
2003-07-01,9715,9715,0,0,0.0,-18716.0
2003-07-02,9715,9899,184,-1,-184.0,-18900.0
2003-07-03,9899,10011,112,0,0.0,-18900.0
2003-07-04,10011,10011,0,0,0.0,-18900.0
2003-07-05,10011,10011,0,-1,-0.0,-18900.0
2003-07-06,10011,9960,-51,-1,51.0,-18849.0
2003-07-07,9960,9715,-245,-1,245.0,-18604.0
2003-07-08,9715,9695,-20,-1,20.0,-18584.0
2003-07-09,9695,9695,0,-1,-0.0,-18584.0
2003-07-10,9695,9695,0,-1,-0.0,-18584.0
2003-07-11,9695,9695,0,-1,-0.0,-18584.0
2003-07-12,9695,9695,0,0,0.0,-18584.0
2003-07-13,9695,9695,0,1,0.0,-18584.0
2003-07-14,9695,9735,40,1,40.0,-18544.0
2003-07-15,9735,9593,-142,-1,142.0,-18402.0
2003-07-16,9593,9593,0,1,0.0,-18402.0
2003-07-17,9593,9695,102,1,102.0,-18300.0
2003-07-18,9695,9695,0,-1,-0.0,-18300.0
2003-07-19,9695,9695,0,0,0.0,-18300.0
2003-07-20,9695,9695,0,-1,-0.0,-18300.0
2003-07-21,9695,9695,0,0,0.0,-18300.0
2003-07-22,9695,9715,20,1,20.0,-18280.0
2003-07-23,9715,9797,82,-1,-82.0,-18362.0
2003-07-24,9797,9695,-102,-1,102.0,-18260.0
2003-07-25,9695,9695,0,0,0.0,-18260.0
2003-07-26,9695,9695,0,0,0.0,-18260.0
2003-07-27,9695,9827,132,-1,-132.0,-18392.0
2003-07-28,9827,9776,-51,1,-51.0,-18443.0
2003-07-29,9776,9797,21,0,0.0,-18443.0
2003-07-30,9797,9695,-102,-1,102.0,-18341.0
2003-07-31,9695,9705,10,-1,-10.0,-18351.0
2003-08-01,9705,9705,0,1,0.0,-18351.0
2003-08-02,9705,9705,0,0,0.0,-18351.0
2003-08-03,9705,9593,-112,0,-0.0,-18351.0
2003-08-04,9593,9409,-184,0,-0.0,-18351.0
2003-08-05,9409,9286,-123,-1,123.0,-18228.0
2003-08-06,9286,9082,-204,0,-0.0,-18228.0
2003-08-07,9082,9031,-51,1,-51.0,-18279.0
2003-08-08,9031,9031,0,0,0.0,-18279.0
2003-08-09,9031,9031,0,1,0.0,-18279.0
2003-08-10,9031,8786,-245,-1,245.0,-18034.0
2003-08-11,8786,8980,194,0,0.0,-18034.0
2003-08-12,8980,9491,511,0,0.0,-18034.0
2003-08-13,9491,9613,122,0,0.0,-18034.0
2003-08-14,9613,9613,0,0,0.0,-18034.0
2003-08-15,9613,9613,0,-1,-0.0,-18034.0
2003-08-16,9613,9613,0,-1,-0.0,-18034.0
2003-08-17,9613,9695,82,0,0.0,-18034.0
2003-08-18,9695,9858,163,0,0.0,-18034.0
2003-08-19,9858,9797,-61,1,-61.0,-18095.0
2003-08-20,9797,9848,51,0,0.0,-18095.0
2003-08-21,9848,9899,51,-1,-51.0,-18146.0
2003-08-22,9899,9899,0,1,0.0,-18146.0
2003-08-23,9899,9899,0,-1,-0.0,-18146.0
2003-08-24,9899,10113,214,1,214.0,-17932.0
2003-08-25,10113,10011,-102,-1,102.0,-17830.0
2003-08-26,10011,10001,-10,-1,10.0,-17820.0
2003-08-27,10001,10001,0,-1,-0.0,-17820.0
2003-08-28,10001,10205,204,0,0.0,-17820.0
2003-08-29,10205,10205,0,0,0.0,-17820.0
2003-08-30,10205,10205,0,-1,-0.0,-17820.0
2003-08-31,10205,10307,102,0,0.0,-17820.0
2003-09-01,10307,10307,0,1,0.0,-17820.0
2003-09-02,10307,10011,-296,0,-0.0,-17820.0
2003-09-03,10011,9817,-194,0,-0.0,-17820.0
2003-09-04,9817,10001,184,-1,-184.0,-18004.0
2003-09-05,10001,10001,0,-1,-0.0,-18004.0
2003-09-06,10001,10001,0,1,0.0,-18004.0
2003-09-07,10001,9797,-204,1,-204.0,-18208.0
2003-09-08,9797,9899,102,1,102.0,-18106.0
2003-09-09,9899,9899,0,0,0.0,-18106.0
2003-09-10,9899,9899,0,1,0.0,-18106.0
2003-09-11,9899,9899,0,0,0.0,-18106.0
2003-09-12,9899,9899,0,1,0.0,-18106.0
2003-09-13,9899,9899,0,0,0.0,-18106.0
2003-09-14,9899,9889,-10,1,-10.0,-18116.0
2003-09-15,9889,9817,-72,-1,72.0,-18044.0
2003-09-16,9817,9868,51,-1,-51.0,-18095.0
2003-09-17,9868,9848,-20,1,-20.0,-18115.0
2003-09-18,9848,9735,-113,-1,113.0,-18002.0
2003-09-19,9735,9735,0,1,0.0,-18002.0
2003-09-20,9735,9735,0,-1,-0.0,-18002.0
2003-09-21,9735,9695,-40,-1,40.0,-17962.0
2003-09-22,9695,9695,0,1,0.0,-17962.0
2003-09-23,9695,9419,-276,0,-0.0,-17962.0
2003-09-24,9419,9031,-388,-1,388.0,-17574.0
2003-09-25,9031,8776,-255,0,-0.0,-17574.0
2003-09-26,8776,8776,0,-1,-0.0,-17574.0
2003-09-27,8776,8776,0,1,0.0,-17574.0
2003-09-28,8776,8644,-132,-1,132.0,-17442.0
2003-09-29,8644,8327,-317,0,-0.0,-17442.0
2003-09-30,8327,8358,31,1,31.0,-17411.0
2003-10-01,8358,8460,102,0,0.0,-17411.0
2003-10-02,8460,8460,0,1,0.0,-17411.0
2003-10-03,8460,8460,0,1,0.0,-17411.0
2003-10-04,8460,8460,0,0,0.0,-17411.0
2003-10-05,8460,8480,20,1,20.0,-17391.0
2003-10-06,8480,8348,-132,0,-0.0,-17391.0
2003-10-07,8348,8164,-184,1,-184.0,-17575.0
2003-10-08,8164,8093,-71,0,-0.0,-17575.0
2003-10-09,8093,8705,612,0,0.0,-17575.0
2003-10-10,8705,8705,0,1,0.0,-17575.0
2003-10-11,8705,8705,0,-1,-0.0,-17575.0
2003-10-12,8705,8878,173,1,173.0,-17402.0
2003-10-13,8878,9338,460,-1,-460.0,-17862.0
2003-10-14,9338,9644,306,1,306.0,-17556.0
2003-10-15,9644,9766,122,-1,-122.0,-17678.0
2003-10-16,9766,9899,133,0,0.0,-17678.0
2003-10-17,9899,9899,0,-1,-0.0,-17678.0
2003-10-18,9899,9899,0,1,0.0,-17678.0
2003-10-19,9899,9858,-41,-1,41.0,-17637.0
2003-10-20,9858,9991,133,1,133.0,-17504.0
2003-10-21,9991,9868,-123,-1,123.0,-17381.0
2003-10-22,9868,9746,-122,0,-0.0,-17381.0
2003-10-23,9746,9878,132,-1,-132.0,-17513.0
2003-10-24,9878,9878,0,-1,-0.0,-17513.0
2003-10-25,9878,9878,0,0,0.0,-17513.0
2003-10-26,9878,10001,123,1,123.0,-17390.0
2003-10-27,10001,10103,102,-1,-102.0,-17492.0
2003-10-28,10103,10154,51,1,51.0,-17441.0
2003-10-29,10154,10256,102,1,102.0,-17339.0
2003-10-30,10256,10144,-112,0,-0.0,-17339.0
2003-10-31,10144,10144,0,-1,-0.0,-17339.0
2003-11-01,10144,10144,0,1,0.0,-17339.0
2003-11-02,10144,10164,20,1,20.0,-17319.0
2003-11-03,10164,10031,-133,-1,133.0,-17186.0
2003-11-04,10031,10113,82,0,0.0,-17186.0
2003-11-05,10113,10613,500,-1,-500.0,-17686.0
2003-11-06,10613,10562,-51,-1,51.0,-17635.0
2003-11-07,10562,10562,0,0,0.0,-17635.0
2003-11-08,10562,10562,0,1,0.0,-17635.0
2003-11-09,10562,10042,-520,-1,520.0,-17115.0
2003-11-10,10042,9797,-245,1,-245.0,-17360.0
2003-11-11,9797,9960,163,0,0.0,-17360.0
2003-11-12,9960,10164,204,-1,-204.0,-17564.0
2003-11-13,10164,10256,92,-1,-92.0,-17656.0
2003-11-14,10256,10256,0,0,0.0,-17656.0
2003-11-15,10256,10256,0,1,0.0,-17656.0
2003-11-16,10256,10001,-255,0,-0.0,-17656.0
2003-11-17,10001,10164,163,1,163.0,-17493.0
2003-11-18,10164,9807,-357,0,-0.0,-17493.0
2003-11-19,9807,10093,286,0,0.0,-17493.0
2003-11-20,10093,10001,-92,0,-0.0,-17493.0
2003-11-21,10001,10001,0,-1,-0.0,-17493.0
2003-11-22,10001,10001,0,1,0.0,-17493.0
2003-11-23,10001,10031,30,-1,-30.0,-17523.0
2003-11-24,10031,10256,225,1,225.0,-17298.0
2003-11-25,10256,10562,306,-1,-306.0,-17604.0
2003-11-26,10562,10358,-204,0,-0.0,-17604.0
2003-11-27,10358,10358,0,1,0.0,-17604.0
2003-11-28,10358,10358,0,0,0.0,-17604.0
2003-11-29,10358,10358,0,-1,-0.0,-17604.0
2003-11-30,10358,10613,255,0,0.0,-17604.0
2003-12-01,10613,11174,561,-1,-561.0,-18165.0
2003-12-02,11174,11736,562,-1,-562.0,-18727.0
2003-12-03,11736,11736,0,1,0.0,-18727.0
2003-12-04,11736,11532,-204,0,-0.0,-18727.0
2003-12-05,11532,11532,0,0,0.0,-18727.0
2003-12-06,11532,11532,0,1,0.0,-18727.0
2003-12-07,11532,11021,-511,0,-0.0,-18727.0
2003-12-08,11021,11838,817,-1,-817.0,-19544.0
2003-12-09,11838,11838,0,-1,-0.0,-19544.0
2003-12-10,11838,11787,-51,0,-0.0,-19544.0
2003-12-11,11787,12501,714,-1,-714.0,-20258.0
2003-12-12,12501,12501,0,0,0.0,-20258.0
2003-12-13,12501,12501,0,-1,-0.0,-20258.0
2003-12-14,12501,13879,1378,0,0.0,-20258.0
2003-12-15,13879,13470,-409,0,-0.0,-20258.0
2003-12-16,13470,13011,-459,-1,459.0,-19799.0
2003-12-17,13011,12195,-816,-1,816.0,-18983.0
2003-12-18,12195,13522,1327,1,1327.0,-17656.0
2003-12-19,13522,13522,0,-1,-0.0,-17656.0
2003-12-20,13522,13522,0,0,0.0,-17656.0
2003-12-21,13522,12756,-766,0,-0.0,-17656.0
2003-12-22,12756,12654,-102,0,-0.0,-17656.0
2003-12-23,12654,12552,-102,0,-0.0,-17656.0
2003-12-24,12552,12552,0,1,0.0,-17656.0
2003-12-25,12552,12195,-357,1,-357.0,-18013.0
2003-12-26,12195,12195,0,0,0.0,-18013.0
2003-12-27,12195,12195,0,-1,-0.0,-18013.0
2003-12-28,12195,12246,51,1,51.0,-17962.0
2003-12-29,12246,12552,306,0,0.0,-17962.0
2003-12-30,12552,12552,0,1,0.0,-17962.0
2003-12-31,12552,12552,0,1,0.0,-17962.0
2004-01-01,12552,12654,102,1,102.0,-17860.0
2004-01-02,12654,12654,0,1,0.0,-17860.0
2004-01-03,12654,12654,0,0,0.0,-17860.0
2004-01-04,12654,12501,-153,-1,153.0,-17707.0
2004-01-05,12501,12042,-459,0,-0.0,-17707.0
2004-01-06,12042,11787,-255,-1,255.0,-17452.0
2004-01-07,11787,11532,-255,-1,255.0,-17197.0
2004-01-08,11532,11991,459,0,0.0,-17197.0
2004-01-09,11991,11991,0,1,0.0,-17197.0
2004-01-10,11991,11991,0,0,0.0,-17197.0
2004-01-11,11991,12042,51,1,51.0,-17146.0
2004-01-12,12042,11991,-51,1,-51.0,-17197.0
2004-01-13,11991,12297,306,-1,-306.0,-17503.0
2004-01-14,12297,11991,-306,1,-306.0,-17809.0
2004-01-15,11991,11787,-204,1,-204.0,-18013.0
2004-01-16,11787,11787,0,0,0.0,-18013.0
2004-01-17,11787,11787,0,1,0.0,-18013.0
2004-01-18,11787,11481,-306,-1,306.0,-17707.0
2004-01-19,11481,11174,-307,0,-0.0,-17707.0
2004-01-20,11174,11174,0,1,0.0,-17707.0
2004-01-21,11174,11174,0,1,0.0,-17707.0
2004-01-22,11174,11174,0,-1,-0.0,-17707.0
2004-01-23,11174,11174,0,-1,-0.0,-17707.0
2004-01-24,11174,11174,0,-1,-0.0,-17707.0
2004-01-25,11174,10766,-408,0,-0.0,-17707.0
2004-01-26,10766,10715,-51,-1,51.0,-17656.0
2004-01-27,10715,10460,-255,1,-255.0,-17911.0
2004-01-28,10460,10919,459,-1,-459.0,-18370.0
2004-01-29,10919,10766,-153,0,-0.0,-18370.0
2004-01-30,10766,10766,0,0,0.0,-18370.0
2004-01-31,10766,10766,0,1,0.0,-18370.0
2004-02-01,10766,10511,-255,0,-0.0,-18370.0
2004-02-02,10511,10817,306,-1,-306.0,-18676.0
2004-02-03,10817,10817,0,0,0.0,-18676.0
2004-02-04,10817,11327,510,0,0.0,-18676.0
2004-02-05,11327,10970,-357,-1,357.0,-18319.0
2004-02-06,10970,10970,0,-1,-0.0,-18319.0
2004-02-07,10970,10970,0,1,0.0,-18319.0
2004-02-08,10970,11021,51,1,51.0,-18268.0
2004-02-09,11021,10817,-204,1,-204.0,-18472.0
2004-02-10,10817,10970,153,-1,-153.0,-18625.0
2004-02-11,10970,11378,408,-1,-408.0,-19033.0
2004-02-12,11378,11276,-102,-1,102.0,-18931.0
2004-02-13,11276,11276,0,0,0.0,-18931.0
2004-02-14,11276,11276,0,0,0.0,-18931.0
2004-02-15,11276,11532,256,0,0.0,-18931.0
2004-02-16,11532,11327,-205,1,-205.0,-19136.0
2004-02-17,11327,11225,-102,0,-0.0,-19136.0
2004-02-18,11225,10970,-255,0,-0.0,-19136.0
2004-02-19,10970,10868,-102,1,-102.0,-19238.0
2004-02-20,10868,10868,0,1,0.0,-19238.0
2004-02-21,10868,10868,0,1,0.0,-19238.0
2004-02-22,10868,10970,102,0,0.0,-19238.0
2004-02-23,10970,11225,255,0,0.0,-19238.0
2004-02-24,11225,11327,102,1,102.0,-19136.0
2004-02-25,11327,11174,-153,-1,153.0,-18983.0
2004-02-26,11174,11174,0,0,0.0,-18983.0
2004-02-27,11174,11174,0,1,0.0,-18983.0
2004-02-28,11174,11174,0,0,0.0,-18983.0
2004-02-29,11174,11174,0,1,0.0,-18983.0
2004-03-01,11174,11072,-102,-1,102.0,-18881.0
2004-03-02,11072,10919,-153,-1,153.0,-18728.0
2004-03-03,10919,11072,153,1,153.0,-18575.0
2004-03-04,11072,11123,51,-1,-51.0,-18626.0
2004-03-05,11123,11123,0,0,0.0,-18626.0
2004-03-06,11123,11123,0,0,0.0,-18626.0
2004-03-07,11123,11378,255,-1,-255.0,-18881.0
2004-03-08,11378,11174,-204,1,-204.0,-19085.0
2004-03-09,11174,11072,-102,0,-0.0,-19085.0
2004-03-10,11072,10868,-204,0,-0.0,-19085.0
2004-03-11,10868,10358,-510,-1,510.0,-18575.0
2004-03-12,10358,10358,0,1,0.0,-18575.0
2004-03-13,10358,10358,0,0,0.0,-18575.0
2004-03-14,10358,10256,-102,0,-0.0,-18575.0
2004-03-15,10256,10185,-71,-1,71.0,-18504.0
2004-03-16,10185,10919,734,0,0.0,-18504.0
2004-03-17,10919,10919,0,1,0.0,-18504.0
2004-03-18,10919,11123,204,1,204.0,-18300.0
2004-03-19,11123,11123,0,-1,-0.0,-18300.0
2004-03-20,11123,11123,0,1,0.0,-18300.0
2004-03-21,11123,10715,-408,1,-408.0,-18708.0
2004-03-22,10715,10817,102,-1,-102.0,-18810.0
2004-03-23,10817,10613,-204,1,-204.0,-19014.0
2004-03-24,10613,10715,102,-1,-102.0,-19116.0
2004-03-25,10715,11021,306,1,306.0,-18810.0
2004-03-26,11021,11021,0,1,0.0,-18810.0
2004-03-27,11021,11021,0,-1,-0.0,-18810.0
2004-03-28,11021,11021,0,1,0.0,-18810.0
2004-03-29,11021,10766,-255,-1,255.0,-18555.0
2004-03-30,10766,10562,-204,1,-204.0,-18759.0
2004-03-31,10562,10562,0,1,0.0,-18759.0
2004-04-01,10562,10766,204,-1,-204.0,-18963.0
2004-04-02,10766,10766,0,0,0.0,-18963.0
2004-04-03,10766,10766,0,-1,-0.0,-18963.0
2004-04-04,10766,10766,0,1,0.0,-18963.0
2004-04-05,10766,10919,153,1,153.0,-18810.0
2004-04-06,10919,10817,-102,1,-102.0,-18912.0
2004-04-07,10817,11430,613,-1,-613.0,-19525.0
2004-04-08,11430,11021,-409,0,-0.0,-19525.0
2004-04-09,11021,11021,0,-1,-0.0,-19525.0
2004-04-10,11021,11021,0,1,0.0,-19525.0
2004-04-11,11021,11327,306,-1,-306.0,-19831.0
2004-04-12,11327,11021,-306,1,-306.0,-20137.0
2004-04-13,11021,11327,306,-1,-306.0,-20443.0
2004-04-14,11327,11327,0,1,0.0,-20443.0
2004-04-15,11327,11583,256,-1,-256.0,-20699.0
2004-04-16,11583,11583,0,-1,-0.0,-20699.0
2004-04-17,11583,11583,0,1,0.0,-20699.0
2004-04-18,11583,11583,0,-1,-0.0,-20699.0
2004-04-19,11583,12144,561,-1,-561.0,-21260.0
2004-04-20,12144,12042,-102,-1,102.0,-21158.0
2004-04-21,12042,11532,-510,-1,510.0,-20648.0
2004-04-22,11532,12042,510,0,0.0,-20648.0
2004-04-23,12042,12042,0,1,0.0,-20648.0
2004-04-24,12042,12042,0,-1,-0.0,-20648.0
2004-04-25,12042,12348,306,1,306.0,-20342.0
2004-04-26,12348,12348,0,-1,-0.0,-20342.0
2004-04-27,12348,12246,-102,1,-102.0,-20444.0
2004-04-28,12246,12246,0,1,0.0,-20444.0
2004-04-29,12246,12348,102,-1,-102.0,-20546.0
2004-04-30,12348,12348,0,1,0.0,-20546.0
2004-05-01,12348,12348,0,1,0.0,-20546.0
2004-05-02,12348,12450,102,-1,-102.0,-20648.0
2004-05-03,12450,12858,408,1,408.0,-20240.0
2004-05-04,12858,12858,0,0,0.0,-20240.0
2004-05-05,12858,12756,-102,0,-0.0,-20240.0
2004-05-06,12756,12042,-714,1,-714.0,-20954.0
2004-05-07,12042,12042,0,0,0.0,-20954.0
2004-05-08,12042,12042,0,-1,-0.0,-20954.0
2004-05-09,12042,10460,-1582,-1,1582.0,-19372.0
2004-05-10,10460,10511,51,-1,-51.0,-19423.0
2004-05-11,10511,10766,255,-1,-255.0,-19678.0
2004-05-12,10766,10409,-357,0,-0.0,-19678.0
2004-05-13,10409,10409,0,-1,-0.0,-19678.0
2004-05-14,10409,10409,0,0,0.0,-19678.0
2004-05-15,10409,10409,0,1,0.0,-19678.0
2004-05-16,10409,9695,-714,-1,714.0,-18964.0
2004-05-17,9695,10001,306,0,0.0,-18964.0
2004-05-18,10001,10256,255,-1,-255.0,-19219.0
2004-05-19,10256,10195,-61,0,-0.0,-19219.0
2004-05-20,10195,10307,112,-1,-112.0,-19331.0
2004-05-21,10307,10307,0,1,0.0,-19331.0
2004-05-22,10307,10307,0,1,0.0,-19331.0
2004-05-23,10307,10256,-51,0,-0.0,-19331.0
2004-05-24,10256,10256,0,1,0.0,-19331.0
2004-05-25,10256,10256,0,-1,-0.0,-19331.0
2004-05-26,10256,10613,357,1,357.0,-18974.0
2004-05-27,10613,10715,102,0,0.0,-18974.0
2004-05-28,10715,10715,0,1,0.0,-18974.0
2004-05-29,10715,10715,0,0,0.0,-18974.0
2004-05-30,10715,10409,-306,1,-306.0,-19280.0
2004-05-31,10409,10715,306,-1,-306.0,-19586.0
2004-06-01,10715,10715,0,1,0.0,-19586.0
2004-06-02,10715,10093,-622,-1,622.0,-18964.0
2004-06-03,10093,9950,-143,0,-0.0,-18964.0
2004-06-04,9950,9950,0,0,0.0,-18964.0
2004-06-05,9950,9950,0,0,0.0,-18964.0
2004-06-06,9950,10511,561,1,561.0,-18403.0
2004-06-07,10511,10154,-357,1,-357.0,-18760.0
2004-06-08,10154,10144,-10,-1,10.0,-18750.0
2004-06-09,10144,9858,-286,1,-286.0,-19036.0
2004-06-10,9858,9184,-674,-1,674.0,-18362.0
2004-06-11,9184,9184,0,0,0.0,-18362.0
2004-06-12,9184,9184,0,-1,-0.0,-18362.0
2004-06-13,9184,9184,0,0,0.0,-18362.0
2004-06-14,9184,8980,-204,0,-0.0,-18362.0
2004-06-15,8980,8888,-92,0,-0.0,-18362.0
2004-06-16,8888,8878,-10,-1,10.0,-18352.0
2004-06-17,8878,8613,-265,0,-0.0,-18352.0
2004-06-18,8613,8613,0,1,0.0,-18352.0
2004-06-19,8613,8613,0,1,0.0,-18352.0
2004-06-20,8613,8552,-61,0,-0.0,-18352.0
2004-06-21,8552,8266,-286,-1,286.0,-18066.0
2004-06-22,8266,8072,-194,1,-194.0,-18260.0
2004-06-23,8072,8470,398,-1,-398.0,-18658.0
2004-06-24,8470,8521,51,1,51.0,-18607.0
2004-06-25,8521,8521,0,0,0.0,-18607.0
2004-06-26,8521,8521,0,1,0.0,-18607.0
2004-06-27,8521,8460,-61,-1,61.0,-18546.0
2004-06-28,8460,8674,214,0,0.0,-18546.0
2004-06-29,8674,8858,184,1,184.0,-18362.0
2004-06-30,8858,8695,-163,1,-163.0,-18525.0
2004-07-01,8695,8623,-72,-1,72.0,-18453.0
2004-07-02,8623,8623,0,-1,-0.0,-18453.0
2004-07-03,8623,8623,0,0,0.0,-18453.0
2004-07-04,8623,8501,-122,-1,122.0,-18331.0
2004-07-05,8501,8470,-31,0,-0.0,-18331.0
2004-07-06,8470,8562,92,1,92.0,-18239.0
2004-07-07,8562,8419,-143,0,-0.0,-18239.0
2004-07-08,8419,8460,41,-1,-41.0,-18280.0
2004-07-09,8460,8460,0,-1,-0.0,-18280.0
2004-07-10,8460,8460,0,-1,-0.0,-18280.0
2004-07-11,8460,8368,-92,-1,92.0,-18188.0
2004-07-12,8368,8276,-92,-1,92.0,-18096.0
2004-07-13,8276,8215,-61,1,-61.0,-18157.0
2004-07-14,8215,8154,-61,-1,61.0,-18096.0
2004-07-15,8154,8235,81,-1,-81.0,-18177.0
2004-07-16,8235,8235,0,-1,-0.0,-18177.0
2004-07-17,8235,8235,0,1,0.0,-18177.0
2004-07-18,8235,8266,31,0,0.0,-18177.0
2004-07-19,8266,8113,-153,1,-153.0,-18330.0
2004-07-20,8113,8215,102,-1,-102.0,-18432.0
2004-07-21,8215,8011,-204,-1,204.0,-18228.0
2004-07-22,8011,8215,204,-1,-204.0,-18432.0
2004-07-23,8215,8215,0,1,0.0,-18432.0
2004-07-24,8215,8215,0,-1,-0.0,-18432.0
2004-07-25,8215,8041,-174,-1,174.0,-18258.0
2004-07-26,8041,8011,-30,-1,30.0,-18228.0
2004-07-27,8011,8052,41,1,41.0,-18187.0
2004-07-28,8052,7960,-92,0,-0.0,-18187.0
2004-07-29,7960,7970,10,1,10.0,-18177.0
2004-07-30,7970,7970,0,-1,-0.0,-18177.0
2004-07-31,7970,7970,0,1,0.0,-18177.0
2004-08-01,7970,7960,-10,1,-10.0,-18187.0
2004-08-02,7960,7868,-92,-1,92.0,-18095.0
2004-08-03,7868,7960,92,-1,-92.0,-18187.0
2004-08-04,7960,8215,255,0,0.0,-18187.0
2004-08-05,8215,8031,-184,-1,184.0,-18003.0
2004-08-06,8031,8031,0,-1,-0.0,-18003.0
2004-08-07,8031,8031,0,1,0.0,-18003.0
2004-08-08,8031,8215,184,-1,-184.0,-18187.0
2004-08-09,8215,8307,92,1,92.0,-18095.0
2004-08-10,8307,8205,-102,1,-102.0,-18197.0
2004-08-11,8205,8307,102,1,102.0,-18095.0
2004-08-12,8307,8419,112,-1,-112.0,-18207.0
2004-08-13,8419,8419,0,1,0.0,-18207.0
2004-08-14,8419,8419,0,0,0.0,-18207.0
2004-08-15,8419,8919,500,1,500.0,-17707.0
2004-08-16,8919,8960,41,0,0.0,-17707.0
2004-08-17,8960,8837,-123,1,-123.0,-17830.0
2004-08-18,8837,8725,-112,1,-112.0,-17942.0
2004-08-19,8725,8960,235,-1,-235.0,-18177.0
2004-08-20,8960,8960,0,0,0.0,-18177.0
2004-08-21,8960,8960,0,1,0.0,-18177.0
2004-08-22,8960,8746,-214,0,-0.0,-18177.0
2004-08-23,8746,8807,61,0,0.0,-18177.0
2004-08-24,8807,8868,61,-1,-61.0,-18238.0
2004-08-25,8868,8878,10,0,0.0,-18238.0
2004-08-26,8878,8827,-51,1,-51.0,-18289.0
2004-08-27,8827,8827,0,1,0.0,-18289.0
2004-08-28,8827,8827,0,-1,-0.0,-18289.0
2004-08-29,8827,8776,-51,0,-0.0,-18289.0
2004-08-30,8776,8858,82,0,0.0,-18289.0
2004-08-31,8858,9052,194,1,194.0,-18095.0
2004-09-01,9052,9674,622,0,0.0,-18095.0
2004-09-02,9674,10103,429,1,429.0,-17666.0
2004-09-03,10103,10103,0,1,0.0,-17666.0
2004-09-04,10103,10103,0,0,0.0,-17666.0
2004-09-05,10103,9909,-194,-1,194.0,-17472.0
2004-09-06,9909,9919,10,0,0.0,-17472.0
2004-09-07,9919,9695,-224,-1,224.0,-17248.0
2004-09-08,9695,10154,459,1,459.0,-16789.0
2004-09-09,10154,10358,204,0,0.0,-16789.0
2004-09-10,10358,10358,0,1,0.0,-16789.0
2004-09-11,10358,10358,0,1,0.0,-16789.0
2004-09-12,10358,10205,-153,0,-0.0,-16789.0
2004-09-13,10205,10205,0,-1,-0.0,-16789.0
2004-09-14,10205,10307,102,-1,-102.0,-16891.0
2004-09-15,10307,10715,408,0,0.0,-16891.0
2004-09-16,10715,10868,153,1,153.0,-16738.0
2004-09-17,10868,10868,0,1,0.0,-16738.0
2004-09-18,10868,10868,0,1,0.0,-16738.0
2004-09-19,10868,10919,51,-1,-51.0,-16789.0
2004-09-20,10919,10817,-102,-1,102.0,-16687.0
2004-09-21,10817,10409,-408,-1,408.0,-16279.0
2004-09-22,10409,10307,-102,-1,102.0,-16177.0
2004-09-23,10307,10307,0,-1,-0.0,-16177.0
2004-09-24,10307,10307,0,1,0.0,-16177.0
2004-09-25,10307,10307,0,0,0.0,-16177.0
2004-09-26,10307,10307,0,0,0.0,-16177.0
2004-09-27,10307,10307,0,1,0.0,-16177.0
2004-09-28,10307,10307,0,0,0.0,-16177.0
2004-09-29,10307,10409,102,1,102.0,-16075.0
2004-09-30,10409,10562,153,0,0.0,-16075.0
2004-10-01,10562,10562,0,0,0.0,-16075.0
2004-10-02,10562,10562,0,-1,-0.0,-16075.0
2004-10-03,10562,10613,51,0,0.0,-16075.0
2004-10-04,10613,10409,-204,1,-204.0,-16279.0
2004-10-05,10409,10511,102,-1,-102.0,-16381.0
2004-10-06,10511,10205,-306,0,-0.0,-16381.0
2004-10-07,10205,10195,-10,-1,10.0,-16371.0
2004-10-08,10195,10195,0,1,0.0,-16371.0
2004-10-09,10195,10195,0,0,0.0,-16371.0
2004-10-10,10195,10409,214,1,214.0,-16157.0
2004-10-11,10409,10174,-235,0,-0.0,-16157.0
2004-10-12,10174,11174,1000,1,1000.0,-15157.0
2004-10-13,11174,11430,256,-1,-256.0,-15413.0
2004-10-14,11430,11123,-307,0,-0.0,-15413.0
2004-10-15,11123,11123,0,-1,-0.0,-15413.0
2004-10-16,11123,11123,0,1,0.0,-15413.0
2004-10-17,11123,10715,-408,1,-408.0,-15821.0
2004-10-18,10715,11072,357,0,0.0,-15821.0
2004-10-19,11072,10868,-204,-1,204.0,-15617.0
2004-10-20,10868,11685,817,-1,-817.0,-16434.0
2004-10-21,11685,11838,153,1,153.0,-16281.0
2004-10-22,11838,11838,0,-1,-0.0,-16281.0
2004-10-23,11838,11838,0,1,0.0,-16281.0
2004-10-24,11838,11123,-715,-1,715.0,-15566.0
2004-10-25,11123,10970,-153,-1,153.0,-15413.0
2004-10-26,10970,11174,204,1,204.0,-15209.0
2004-10-27,11174,11072,-102,-1,102.0,-15107.0
2004-10-28,11072,10511,-561,-1,561.0,-14546.0
2004-10-29,10511,10511,0,-1,-0.0,-14546.0
2004-10-30,10511,10511,0,0,0.0,-14546.0
2004-10-31,10511,10715,204,1,204.0,-14342.0
2004-11-01,10715,11174,459,-1,-459.0,-14801.0
2004-11-02,11174,11787,613,0,0.0,-14801.0
2004-11-03,11787,11685,-102,-1,102.0,-14699.0
2004-11-04,11685,12195,510,0,0.0,-14699.0
2004-11-05,12195,12195,0,0,0.0,-14699.0
2004-11-06,12195,12195,0,-1,-0.0,-14699.0
2004-11-07,12195,11991,-204,-1,204.0,-14495.0
2004-11-08,11991,11940,-51,-1,51.0,-14444.0
2004-11-09,11940,12654,714,1,714.0,-13730.0
2004-11-10,12654,12909,255,1,255.0,-13475.0
2004-11-11,12909,13522,613,0,0.0,-13475.0
2004-11-12,13522,13522,0,0,0.0,-13475.0
2004-11-13,13522,13522,0,-1,-0.0,-13475.0
2004-11-14,13522,13368,-154,1,-154.0,-13629.0
2004-11-15,13368,13419,51,1,51.0,-13578.0
2004-11-16,13419,13419,0,0,0.0,-13578.0
2004-11-17,13419,12348,-1071,1,-1071.0,-14649.0
2004-11-18,12348,12552,204,-1,-204.0,-14853.0
2004-11-19,12552,12552,0,-1,-0.0,-14853.0
2004-11-20,12552,12552,0,0,0.0,-14853.0
2004-11-21,12552,11634,-918,0,-0.0,-14853.0
2004-11-22,11634,11685,51,0,0.0,-14853.0
2004-11-23,11685,12399,714,-1,-714.0,-15567.0
2004-11-24,12399,12552,153,1,153.0,-15414.0
2004-11-25,12552,12807,255,-1,-255.0,-15669.0
2004-11-26,12807,12807,0,1,0.0,-15669.0
2004-11-27,12807,12807,0,1,0.0,-15669.0
2004-11-28,12807,12858,51,1,51.0,-15618.0
2004-11-29,12858,13215,357,-1,-357.0,-15975.0
2004-11-30,13215,13368,153,0,0.0,-15975.0
2004-12-01,13368,13215,-153,0,-0.0,-15975.0
2004-12-02,13215,12960,-255,-1,255.0,-15720.0
2004-12-03,12960,12960,0,1,0.0,-15720.0
2004-12-04,12960,12960,0,1,0.0,-15720.0
2004-12-05,12960,12858,-102,0,-0.0,-15720.0
2004-12-06,12858,12603,-255,-1,255.0,-15465.0
2004-12-07,12603,13062,459,0,0.0,-15465.0
2004-12-08,13062,13266,204,1,204.0,-15261.0
2004-12-09,13266,12756,-510,1,-510.0,-15771.0
2004-12-10,12756,12756,0,-1,-0.0,-15771.0
2004-12-11,12756,12756,0,0,0.0,-15771.0
2004-12-12,12756,12501,-255,1,-255.0,-16026.0
2004-12-13,12501,12246,-255,-1,255.0,-15771.0
2004-12-14,12246,12348,102,0,0.0,-15771.0
2004-12-15,12348,12858,510,1,510.0,-15261.0
2004-12-16,12858,12450,-408,0,-0.0,-15261.0
2004-12-17,12450,12450,0,-1,-0.0,-15261.0
2004-12-18,12450,12450,0,0,0.0,-15261.0
2004-12-19,12450,12042,-408,-1,408.0,-14853.0
2004-12-20,12042,12042,0,1,0.0,-14853.0
2004-12-21,12042,11940,-102,1,-102.0,-14955.0
2004-12-22,11940,11481,-459,1,-459.0,-15414.0
2004-12-23,11481,11378,-103,0,-0.0,-15414.0
2004-12-24,11378,11378,0,1,0.0,-15414.0
2004-12-25,11378,11378,0,-1,-0.0,-15414.0
2004-12-26,11378,11123,-255,0,-0.0,-15414.0
2004-12-27,11123,11787,664,0,0.0,-15414.0
2004-12-28,11787,12042,255,0,0.0,-15414.0
2004-12-29,12042,12144,102,1,102.0,-15312.0
2004-12-30,12144,12144,0,1,0.0,-15312.0
2004-12-31,12144,12144,0,-1,-0.0,-15312.0
2005-01-01,12144,12144,0,-1,-0.0,-15312.0
2005-01-02,12144,12042,-102,0,-0.0,-15312.0
2005-01-03,12042,11532,-510,1,-510.0,-15822.0
2005-01-04,11532,11634,102,-1,-102.0,-15924.0
2005-01-05,11634,11634,0,-1,-0.0,-15924.0
2005-01-06,11634,11481,-153,-1,153.0,-15771.0
2005-01-07,11481,11481,0,0,0.0,-15771.0
2005-01-08,11481,11481,0,0,0.0,-15771.0
2005-01-09,11481,11685,204,1,204.0,-15567.0
2005-01-10,11685,12144,459,1,459.0,-15108.0
2005-01-11,12144,11838,-306,-1,306.0,-14802.0
2005-01-12,11838,11838,0,-1,-0.0,-14802.0
2005-01-13,11838,12042,204,-1,-204.0,-15006.0
2005-01-14,12042,12042,0,0,0.0,-15006.0
2005-01-15,12042,12042,0,1,0.0,-15006.0
2005-01-16,12042,12144,102,1,102.0,-14904.0
2005-01-17,12144,12042,-102,0,-0.0,-14904.0
2005-01-18,12042,11583,-459,1,-459.0,-15363.0
2005-01-19,11583,11430,-153,-1,153.0,-15210.0
2005-01-20,11430,11430,0,-1,-0.0,-15210.0
2005-01-21,11430,11430,0,0,0.0,-15210.0
2005-01-22,11430,11430,0,1,0.0,-15210.0
2005-01-23,11430,11634,204,-1,-204.0,-15414.0
2005-01-24,11634,11532,-102,-1,102.0,-15312.0
2005-01-25,11532,11430,-102,-1,102.0,-15210.0
2005-01-26,11430,11583,153,1,153.0,-15057.0
2005-01-27,11583,11327,-256,0,-0.0,-15057.0
2005-01-28,11327,11327,0,-1,-0.0,-15057.0
2005-01-29,11327,11327,0,-1,-0.0,-15057.0
2005-01-30,11327,11327,0,0,0.0,-15057.0
2005-01-31,11327,11225,-102,0,-0.0,-15057.0
2005-02-01,11225,11225,0,0,0.0,-15057.0
2005-02-02,11225,11174,-51,-1,51.0,-15006.0
2005-02-03,11174,11072,-102,0,-0.0,-15006.0
2005-02-04,11072,11072,0,0,0.0,-15006.0
2005-02-05,11072,11072,0,1,0.0,-15006.0
2005-02-06,11072,11378,306,1,306.0,-14700.0
2005-02-07,11378,11378,0,1,0.0,-14700.0
2005-02-08,11378,11378,0,1,0.0,-14700.0
2005-02-09,11378,11378,0,1,0.0,-14700.0
2005-02-10,11378,11838,460,1,460.0,-14240.0
2005-02-11,11838,11838,0,0,0.0,-14240.0
2005-02-12,11838,11838,0,0,0.0,-14240.0
2005-02-13,11838,12042,204,1,204.0,-14036.0
2005-02-14,12042,12093,51,1,51.0,-13985.0
2005-02-15,12093,12042,-51,-1,51.0,-13934.0
2005-02-16,12042,12093,51,1,51.0,-13883.0
2005-02-17,12093,12144,51,0,0.0,-13883.0
2005-02-18,12144,12144,0,0,0.0,-13883.0
2005-02-19,12144,12144,0,-1,-0.0,-13883.0
2005-02-20,12144,12960,816,1,816.0,-13067.0
2005-02-21,12960,12450,-510,-1,510.0,-12557.0
2005-02-22,12450,12246,-204,-1,204.0,-12353.0
2005-02-23,12246,12399,153,1,153.0,-12200.0
2005-02-24,12399,12348,-51,1,-51.0,-12251.0
2005-02-25,12348,12348,0,1,0.0,-12251.0
2005-02-26,12348,12348,0,1,0.0,-12251.0
2005-02-27,12348,13011,663,-1,-663.0,-12914.0
2005-02-28,13011,13011,0,-1,-0.0,-12914.0
2005-03-01,13011,14032,1021,0,0.0,-12914.0
2005-03-02,14032,14287,255,1,255.0,-12659.0
2005-03-03,14287,13879,-408,1,-408.0,-13067.0
2005-03-04,13879,13879,0,0,0.0,-13067.0
2005-03-05,13879,13879,0,0,0.0,-13067.0
2005-03-06,13879,14083,204,-1,-204.0,-13271.0
2005-03-07,14083,13828,-255,-1,255.0,-13016.0
2005-03-08,13828,13777,-51,0,-0.0,-13016.0
2005-03-09,13777,14695,918,0,0.0,-13016.0
2005-03-10,14695,14746,51,1,51.0,-12965.0
2005-03-11,14746,14746,0,0,0.0,-12965.0
2005-03-12,14746,14746,0,0,0.0,-12965.0
2005-03-13,14746,14491,-255,1,-255.0,-13220.0
2005-03-14,14491,13675,-816,0,-0.0,-13220.0
2005-03-15,13675,13368,-307,1,-307.0,-13527.0
2005-03-16,13368,12909,-459,0,-0.0,-13527.0
2005-03-17,12909,12756,-153,0,-0.0,-13527.0
2005-03-18,12756,12756,0,1,0.0,-13527.0
2005-03-19,12756,12756,0,0,0.0,-13527.0
2005-03-20,12756,12399,-357,0,-0.0,-13527.0
2005-03-21,12399,12654,255,0,0.0,-13527.0
2005-03-22,12654,12399,-255,-1,255.0,-13272.0
2005-03-23,12399,12042,-357,-1,357.0,-12915.0
2005-03-24,12042,12348,306,1,306.0,-12609.0
2005-03-25,12348,12348,0,1,0.0,-12609.0
2005-03-26,12348,12348,0,0,0.0,-12609.0
2005-03-27,12348,12654,306,-1,-306.0,-12915.0
2005-03-28,12654,12807,153,1,153.0,-12762.0
2005-03-29,12807,12552,-255,-1,255.0,-12507.0
2005-03-30,12552,12552,0,0,0.0,-12507.0
2005-03-31,12552,12246,-306,-1,306.0,-12201.0
2005-04-01,12246,12246,0,-1,-0.0,-12201.0
2005-04-02,12246,12246,0,-1,-0.0,-12201.0
2005-04-03,12246,12093,-153,0,-0.0,-12201.0
2005-04-04,12093,12093,0,1,0.0,-12201.0
2005-04-05,12093,11889,-204,1,-204.0,-12405.0
2005-04-06,11889,12144,255,1,255.0,-12150.0
2005-04-07,12144,11889,-255,0,-0.0,-12150.0
2005-04-08,11889,11889,0,0,0.0,-12150.0
2005-04-09,11889,11889,0,0,0.0,-12150.0
2005-04-10,11889,11634,-255,-1,255.0,-11895.0
2005-04-11,11634,11685,51,0,0.0,-11895.0
2005-04-12,11685,11481,-204,1,-204.0,-12099.0
2005-04-13,11481,11021,-460,0,-0.0,-12099.0
2005-04-14,11021,10919,-102,0,-0.0,-12099.0
2005-04-15,10919,10919,0,-1,-0.0,-12099.0
2005-04-16,10919,10919,0,1,0.0,-12099.0
2005-04-17,10919,10970,51,0,0.0,-12099.0
2005-04-18,10970,11021,51,0,0.0,-12099.0
2005-04-19,11021,10817,-204,-1,204.0,-11895.0
2005-04-20,10817,10970,153,0,0.0,-11895.0
2005-04-21,10970,10919,-51,-1,51.0,-11844.0
2005-04-22,10919,10919,0,-1,-0.0,-11844.0
2005-04-23,10919,10919,0,0,0.0,-11844.0
2005-04-24,10919,11072,153,-1,-153.0,-11997.0
2005-04-25,11072,11481,409,-1,-409.0,-12406.0
2005-04-26,11481,11225,-256,1,-256.0,-12662.0
2005-04-27,11225,10817,-408,-1,408.0,-12254.0
2005-04-28,10817,10664,-153,-1,153.0,-12101.0
2005-04-29,10664,10664,0,1,0.0,-12101.0
2005-04-30,10664,10664,0,0,0.0,-12101.0
2005-05-01,10664,10715,51,-1,-51.0,-12152.0
2005-05-02,10715,10613,-102,0,-0.0,-12152.0
2005-05-03,10613,10868,255,-1,-255.0,-12407.0
2005-05-04,10868,10868,0,-1,-0.0,-12407.0
2005-05-05,10868,11225,357,-1,-357.0,-12764.0
2005-05-06,11225,11225,0,-1,-0.0,-12764.0
2005-05-07,11225,11225,0,1,0.0,-12764.0
2005-05-08,11225,10817,-408,-1,408.0,-12356.0
2005-05-09,10817,10919,102,1,102.0,-12254.0
2005-05-10,10919,10664,-255,1,-255.0,-12509.0
2005-05-11,10664,10613,-51,0,-0.0,-12509.0
2005-05-12,10613,10664,51,-1,-51.0,-12560.0
2005-05-13,10664,10664,0,0,0.0,-12560.0
2005-05-14,10664,10664,0,-1,-0.0,-12560.0
2005-05-15,10664,10715,51,0,0.0,-12560.0
2005-05-16,10715,10664,-51,-1,51.0,-12509.0
2005-05-17,10664,10919,255,1,255.0,-12254.0
2005-05-18,10919,11123,204,-1,-204.0,-12458.0
2005-05-19,11123,11072,-51,-1,51.0,-12407.0
2005-05-20,11072,11072,0,-1,-0.0,-12407.0
2005-05-21,11072,11072,0,1,0.0,-12407.0
2005-05-22,11072,11021,-51,1,-51.0,-12458.0
2005-05-23,11021,10919,-102,-1,102.0,-12356.0
2005-05-24,10919,10919,0,-1,-0.0,-12356.0
2005-05-25,10919,10817,-102,0,-0.0,-12356.0
2005-05-26,10817,10970,153,1,153.0,-12203.0
2005-05-27,10970,10970,0,1,0.0,-12203.0
2005-05-28,10970,10970,0,0,0.0,-12203.0
2005-05-29,10970,11021,51,0,0.0,-12203.0
2005-05-30,11021,10919,-102,-1,102.0,-12101.0
2005-05-31,10919,11021,102,-1,-102.0,-12203.0
2005-06-01,11021,11327,306,0,0.0,-12203.0
2005-06-02,11327,11225,-102,-1,102.0,-12101.0
2005-06-03,11225,11225,0,1,0.0,-12101.0
2005-06-04,11225,11225,0,-1,-0.0,-12101.0
2005-06-05,11225,11225,0,-1,-0.0,-12101.0
2005-06-06,11225,10970,-255,-1,255.0,-11846.0
2005-06-07,10970,10919,-51,0,-0.0,-11846.0
2005-06-08,10919,11225,306,-1,-306.0,-12152.0
2005-06-09,11225,11889,664,-1,-664.0,-12816.0
2005-06-10,11889,11889,0,1,0.0,-12816.0
2005-06-11,11889,11889,0,1,0.0,-12816.0
2005-06-12,11889,11940,51,0,0.0,-12816.0
2005-06-13,11940,11736,-204,1,-204.0,-13020.0
2005-06-14,11736,12144,408,-1,-408.0,-13428.0
2005-06-15,12144,12144,0,0,0.0,-13428.0
2005-06-16,12144,11889,-255,-1,255.0,-13173.0
2005-06-17,11889,11889,0,0,0.0,-13173.0
2005-06-18,11889,11889,0,1,0.0,-13173.0
2005-06-19,11889,11634,-255,1,-255.0,-13428.0
2005-06-20,11634,11481,-153,0,-0.0,-13428.0
2005-06-21,11481,11940,459,-1,-459.0,-13887.0
2005-06-22,11940,12399,459,0,0.0,-13887.0
2005-06-23,12399,12144,-255,0,-0.0,-13887.0
2005-06-24,12144,12144,0,1,0.0,-13887.0
2005-06-25,12144,12144,0,-1,-0.0,-13887.0
2005-06-26,12144,11838,-306,1,-306.0,-14193.0
2005-06-27,11838,11991,153,-1,-153.0,-14346.0
2005-06-28,11991,12093,102,1,102.0,-14244.0
2005-06-29,12093,12399,306,-1,-306.0,-14550.0
2005-06-30,12399,13624,1225,1,1225.0,-13325.0
2005-07-01,13624,13624,0,1,0.0,-13325.0
2005-07-02,13624,13624,0,1,0.0,-13325.0
2005-07-03,13624,14389,765,1,765.0,-12560.0
2005-07-04,14389,14389,0,-1,-0.0,-12560.0
2005-07-05,14389,14338,-51,1,-51.0,-12611.0
2005-07-06,14338,13879,-459,0,-0.0,-12611.0
2005-07-07,13879,13164,-715,0,-0.0,-12611.0
2005-07-08,13164,13164,0,-1,-0.0,-12611.0
2005-07-09,13164,13164,0,1,0.0,-12611.0
2005-07-10,13164,13573,409,1,409.0,-12202.0
2005-07-11,13573,14134,561,1,561.0,-11641.0
2005-07-12,14134,13828,-306,0,-0.0,-11641.0
2005-07-13,13828,13726,-102,0,-0.0,-11641.0
2005-07-14,13726,14287,561,-1,-561.0,-12202.0
2005-07-15,14287,14287,0,0,0.0,-12202.0
2005-07-16,14287,14287,0,0,0.0,-12202.0
2005-07-17,14287,15103,816,0,0.0,-12202.0
2005-07-18,15103,15511,408,-1,-408.0,-12610.0
2005-07-19,15511,14899,-612,0,-0.0,-12610.0
2005-07-20,14899,15614,715,-1,-715.0,-13325.0
2005-07-21,15614,14695,-919,0,-0.0,-13325.0
2005-07-22,14695,14695,0,1,0.0,-13325.0
2005-07-23,14695,14695,0,1,0.0,-13325.0
2005-07-24,14695,15103,408,0,0.0,-13325.0
2005-07-25,15103,15001,-102,1,-102.0,-13427.0
2005-07-26,15001,15205,204,1,204.0,-13223.0
2005-07-27,15205,17450,2245,-1,-2245.0,-15468.0
2005-07-28,17450,16328,-1122,-1,1122.0,-14346.0
2005-07-29,16328,16328,0,1,0.0,-14346.0
2005-07-30,16328,16328,0,-1,-0.0,-14346.0
2005-07-31,16328,16940,612,0,0.0,-14346.0
2005-08-01,16940,17042,102,-1,-102.0,-14448.0
2005-08-02,17042,16532,-510,-1,510.0,-13938.0
2005-08-03,16532,16226,-306,1,-306.0,-14244.0
2005-08-04,16226,15920,-306,-1,306.0,-13938.0
2005-08-05,15920,15920,0,-1,-0.0,-13938.0
2005-08-06,15920,15920,0,0,0.0,-13938.0
2005-08-07,15920,15716,-204,-1,204.0,-13734.0
2005-08-08,15716,15920,204,1,204.0,-13530.0
2005-08-09,15920,15665,-255,0,-0.0,-13530.0
2005-08-10,15665,16175,510,-1,-510.0,-14040.0
2005-08-11,16175,16787,612,0,0.0,-14040.0
2005-08-12,16787,16787,0,1,0.0,-14040.0
2005-08-13,16787,16787,0,0,0.0,-14040.0
2005-08-14,16787,16787,0,1,0.0,-14040.0
2005-08-15,16787,15614,-1173,0,-0.0,-14040.0
2005-08-16,15614,15460,-154,1,-154.0,-14194.0
2005-08-17,15460,15307,-153,1,-153.0,-14347.0
2005-08-18,15307,15205,-102,1,-102.0,-14449.0
2005-08-19,15205,15205,0,0,0.0,-14449.0
2005-08-20,15205,15205,0,-1,-0.0,-14449.0
2005-08-21,15205,16124,919,0,0.0,-14449.0
2005-08-22,16124,16277,153,1,153.0,-14296.0
2005-08-23,16277,16124,-153,1,-153.0,-14449.0
2005-08-24,16124,17195,1071,1,1071.0,-13378.0
2005-08-25,17195,17348,153,0,0.0,-13378.0
2005-08-26,17348,17348,0,-1,-0.0,-13378.0
2005-08-27,17348,17348,0,0,0.0,-13378.0
2005-08-28,17348,17348,0,1,0.0,-13378.0
2005-08-29,17348,17655,307,-1,-307.0,-13685.0
2005-08-30,17655,17297,-358,1,-358.0,-14043.0
2005-08-31,17297,16991,-306,1,-306.0,-14349.0
2005-09-01,16991,17093,102,-1,-102.0,-14451.0
2005-09-02,17093,17093,0,1,0.0,-14451.0
2005-09-03,17093,17093,0,0,0.0,-14451.0
2005-09-04,17093,16889,-204,1,-204.0,-14655.0
2005-09-05,16889,16838,-51,0,-0.0,-14655.0
2005-09-06,16838,17808,970,-1,-970.0,-15625.0
2005-09-07,17808,17552,-256,1,-256.0,-15881.0
2005-09-08,17552,17859,307,0,0.0,-15881.0
2005-09-09,17859,17859,0,1,0.0,-15881.0
2005-09-10,17859,17859,0,1,0.0,-15881.0
2005-09-11,17859,18012,153,0,0.0,-15881.0
2005-09-12,18012,17859,-153,0,-0.0,-15881.0
2005-09-13,17859,18165,306,1,306.0,-15575.0
2005-09-14,18165,17603,-562,0,-0.0,-15575.0
2005-09-15,17603,17961,358,1,358.0,-15217.0
2005-09-16,17961,17961,0,1,0.0,-15217.0
2005-09-17,17961,17961,0,-1,-0.0,-15217.0
2005-09-18,17961,17961,0,1,0.0,-15217.0
2005-09-19,17961,19083,1122,1,1122.0,-14095.0
2005-09-20,19083,18777,-306,1,-306.0,-14401.0
2005-09-21,18777,19287,510,0,0.0,-14401.0
2005-09-22,19287,18777,-510,-1,510.0,-13891.0
2005-09-23,18777,18777,0,-1,-0.0,-13891.0
2005-09-24,18777,18777,0,-1,-0.0,-13891.0
2005-09-25,18777,19032,255,1,255.0,-13636.0
2005-09-26,19032,18981,-51,1,-51.0,-13687.0
2005-09-27,18981,19542,561,-1,-561.0,-14248.0
2005-09-28,19542,20206,664,-1,-664.0,-14912.0
2005-09-29,20206,20002,-204,1,-204.0,-15116.0
2005-09-30,20002,20002,0,1,0.0,-15116.0
2005-10-01,20002,20002,0,1,0.0,-15116.0
2005-10-02,20002,20002,0,-1,-0.0,-15116.0
2005-10-03,20002,20206,204,1,204.0,-14912.0
2005-10-04,20206,19900,-306,-1,306.0,-14606.0
2005-10-05,19900,19338,-562,-1,562.0,-14044.0
2005-10-06,19338,18930,-408,-1,408.0,-13636.0
2005-10-07,18930,18930,0,-1,-0.0,-13636.0
2005-10-08,18930,18930,0,0,0.0,-13636.0
2005-10-09,18930,18930,0,-1,-0.0,-13636.0
2005-10-10,18930,19032,102,-1,-102.0,-13738.0
2005-10-11,19032,18471,-561,0,-0.0,-13738.0
2005-10-12,18471,18879,408,-1,-408.0,-14146.0
2005-10-13,18879,18216,-663,0,-0.0,-14146.0
2005-10-14,18216,18216,0,-1,-0.0,-14146.0
2005-10-15,18216,18216,0,-1,-0.0,-14146.0
2005-10-16,18216,18216,0,1,0.0,-14146.0
2005-10-17,18216,18981,765,-1,-765.0,-14911.0
2005-10-18,18981,19032,51,-1,-51.0,-14962.0
2005-10-19,19032,18879,-153,1,-153.0,-15115.0
2005-10-20,18879,19440,561,0,0.0,-15115.0
2005-10-21,19440,19440,0,1,0.0,-15115.0
2005-10-22,19440,19440,0,0,0.0,-15115.0
2005-10-23,19440,19389,-51,-1,51.0,-15064.0
2005-10-24,19389,19134,-255,1,-255.0,-15319.0
2005-10-25,19134,19083,-51,1,-51.0,-15370.0
2005-10-26,19083,18930,-153,-1,153.0,-15217.0
2005-10-27,18930,18420,-510,0,-0.0,-15217.0
2005-10-28,18420,18420,0,1,0.0,-15217.0
2005-10-29,18420,18420,0,1,0.0,-15217.0
2005-10-30,18420,18777,357,0,0.0,-15217.0
2005-10-31,18777,19798,1021,1,1021.0,-14196.0
2005-11-01,19798,20104,306,0,0.0,-14196.0
2005-11-02,20104,19900,-204,1,-204.0,-14400.0
2005-11-03,19900,19849,-51,-1,51.0,-14349.0
2005-11-04,19849,19849,0,-1,-0.0,-14349.0
2005-11-05,19849,19849,0,1,0.0,-14349.0
2005-11-06,19849,19491,-358,-1,358.0,-13991.0
2005-11-07,19491,20053,562,1,562.0,-13429.0
2005-11-08,20053,20053,0,-1,-0.0,-13429.0
2005-11-09,20053,20308,255,0,0.0,-13429.0
2005-11-10,20308,20665,357,0,0.0,-13429.0
2005-11-11,20665,20665,0,-1,-0.0,-13429.0
2005-11-12,20665,20665,0,-1,-0.0,-13429.0
2005-11-13,20665,23369,2704,-1,-2704.0,-16133.0
2005-11-14,23369,26227,2858,0,0.0,-16133.0
2005-11-15,26227,26380,153,-1,-153.0,-16286.0
2005-11-16,26380,26431,51,1,51.0,-16235.0
2005-11-17,26431,26125,-306,1,-306.0,-16541.0
2005-11-18,26125,26125,0,0,0.0,-16541.0
2005-11-19,26125,26125,0,0,0.0,-16541.0
2005-11-20,26125,25359,-766,0,-0.0,-16541.0
2005-11-21,25359,26482,1123,-1,-1123.0,-17664.0
2005-11-22,26482,30411,3929,0,0.0,-17664.0
2005-11-23,30411,32452,2041,-1,-2041.0,-19705.0
2005-11-24,32452,31023,-1429,1,-1429.0,-21134.0
2005-11-25,31023,31023,0,1,0.0,-21134.0
2005-11-26,31023,31023,0,0,0.0,-21134.0
2005-11-27,31023,29441,-1582,0,-0.0,-21134.0
2005-11-28,29441,29084,-357,0,-0.0,-21134.0
2005-11-29,29084,30360,1276,-1,-1276.0,-22410.0
2005-11-30,30360,29747,-613,0,-0.0,-22410.0
2005-12-01,29747,28574,-1173,1,-1173.0,-23583.0
2005-12-02,28574,28574,0,1,0.0,-23583.0
2005-12-03,28574,28574,0,-1,-0.0,-23583.0
2005-12-04,28574,28472,-102,-1,102.0,-23481.0
2005-12-05,28472,27349,-1123,0,-0.0,-23481.0
2005-12-06,27349,27043,-306,-1,306.0,-23175.0
2005-12-07,27043,28217,1174,1,1174.0,-22001.0
2005-12-08,28217,30002,1785,1,1785.0,-20216.0
2005-12-09,30002,30002,0,0,0.0,-20216.0
2005-12-10,30002,30002,0,1,0.0,-20216.0
2005-12-11,30002,31482,1480,-1,-1480.0,-21696.0
2005-12-12,31482,31482,0,1,0.0,-21696.0
2005-12-13,31482,31329,-153,0,-0.0,-21696.0
2005-12-14,31329,31329,0,-1,-0.0,-21696.0
2005-12-15,31329,30717,-612,1,-612.0,-22308.0
2005-12-16,30717,30717,0,0,0.0,-22308.0
2005-12-17,30717,30717,0,-1,-0.0,-22308.0
2005-12-18,30717,31839,1122,0,0.0,-22308.0
2005-12-19,31839,34697,2858,0,0.0,-22308.0
2005-12-20,34697,34493,-204,1,-204.0,-22512.0
2005-12-21,34493,35717,1224,1,1224.0,-21288.0
2005-12-22,35717,35207,-510,-1,510.0,-20778.0
2005-12-23,35207,35207,0,0,0.0,-20778.0
2005-12-24,35207,35207,0,-1,-0.0,-20778.0
2005-12-25,35207,34186,-1021,-1,1021.0,-19757.0
2005-12-26,34186,34799,613,0,0.0,-19757.0
2005-12-27,34799,34135,-664,0,-0.0,-19757.0
2005-12-28,34135,34697,562,1,562.0,-19195.0
2005-12-29,34697,34697,0,0,0.0,-19195.0
2005-12-30,34697,34697,0,0,0.0,-19195.0
2005-12-31,34697,34697,0,-1,-0.0,-19195.0
2006-01-01,34697,36330,1633,1,1633.0,-17562.0
2006-01-02,36330,35411,-919,0,-0.0,-17562.0
2006-01-03,35411,34289,-1122,-1,1122.0,-16440.0
2006-01-04,34289,34084,-205,1,-205.0,-16645.0
2006-01-05,34084,33370,-714,0,-0.0,-16645.0
2006-01-06,33370,33370,0,0,0.0,-16645.0
2006-01-07,33370,33370,0,-1,-0.0,-16645.0
2006-01-08,33370,30819,-2551,-1,2551.0,-14094.0
2006-01-09,30819,29594,-1225,1,-1225.0,-15319.0
2006-01-10,29594,30819,1225,1,1225.0,-14094.0
2006-01-11,30819,30105,-714,-1,714.0,-13380.0
2006-01-12,30105,29900,-205,1,-205.0,-13585.0
2006-01-13,29900,29900,0,-1,-0.0,-13585.0
2006-01-14,29900,29900,0,1,0.0,-13585.0
2006-01-15,29900,31839,1939,1,1939.0,-11646.0
2006-01-16,31839,29492,-2347,1,-2347.0,-13993.0
2006-01-17,29492,27910,-1582,1,-1582.0,-15575.0
2006-01-18,27910,31380,3470,-1,-3470.0,-19045.0
2006-01-19,31380,29492,-1888,0,-0.0,-19045.0
2006-01-20,29492,29492,0,-1,-0.0,-19045.0
2006-01-21,29492,29492,0,0,0.0,-19045.0
2006-01-22,29492,26533,-2959,1,-2959.0,-22004.0
2006-01-23,26533,26839,306,-1,-306.0,-22310.0
2006-01-24,26839,26941,102,1,102.0,-22208.0
2006-01-25,26941,29594,2653,1,2653.0,-19555.0
2006-01-26,29594,30156,562,-1,-562.0,-20117.0
2006-01-27,30156,30156,0,-1,-0.0,-20117.0
2006-01-28,30156,30156,0,0,0.0,-20117.0
2006-01-29,30156,30156,0,1,0.0,-20117.0
2006-01-30,30156,30768,612,1,612.0,-19505.0
2006-01-31,30768,29084,-1684,0,-0.0,-19505.0
2006-02-01,29084,29951,867,-1,-867.0,-20372.0
2006-02-02,29951,28013,-1938,1,-1938.0,-22310.0
2006-02-03,28013,28013,0,1,0.0,-22310.0
2006-02-04,28013,28013,0,0,0.0,-22310.0
2006-02-05,28013,27553,-460,0,-0.0,-22310.0
2006-02-06,27553,27553,0,1,0.0,-22310.0
2006-02-07,27553,26839,-714,1,-714.0,-23024.0
2006-02-08,26839,26839,0,0,0.0,-23024.0
2006-02-09,26839,27349,510,0,0.0,-23024.0
2006-02-10,27349,27349,0,-1,-0.0,-23024.0
2006-02-11,27349,27349,0,0,0.0,-23024.0
2006-02-12,27349,27910,561,0,0.0,-23024.0
2006-02-13,27910,28421,511,-1,-511.0,-23535.0
2006-02-14,28421,28319,-102,1,-102.0,-23637.0
2006-02-15,28319,29288,969,1,969.0,-22668.0
2006-02-16,29288,30615,1327,0,0.0,-22668.0
2006-02-17,30615,30615,0,0,0.0,-22668.0
2006-02-18,30615,30615,0,-1,-0.0,-22668.0
2006-02-19,30615,32145,1530,-1,-1530.0,-24198.0
2006-02-20,32145,34186,2041,-1,-2041.0,-26239.0
2006-02-21,34186,36738,2552,-1,-2552.0,-28791.0
2006-02-22,36738,37911,1173,0,0.0,-28791.0
2006-02-23,37911,36738,-1173,1,-1173.0,-29964.0
2006-02-24,36738,36738,0,0,0.0,-29964.0
2006-02-25,36738,36738,0,-1,-0.0,-29964.0
2006-02-26,36738,35717,-1021,0,-0.0,-29964.0
2006-02-27,35717,37248,1531,1,1531.0,-28433.0
2006-02-28,37248,37248,0,-1,-0.0,-28433.0
2006-03-01,37248,36636,-612,0,-0.0,-28433.0
2006-03-02,36636,34186,-2450,1,-2450.0,-30883.0
2006-03-03,34186,34186,0,-1,-0.0,-30883.0
2006-03-04,34186,34186,0,1,0.0,-30883.0
2006-03-05,34186,35513,1327,1,1327.0,-29556.0
2006-03-06,35513,34493,-1020,0,-0.0,-29556.0
2006-03-07,34493,35411,918,0,0.0,-29556.0
2006-03-08,35411,35258,-153,-1,153.0,-29403.0
2006-03-09,35258,34799,-459,1,-459.0,-29862.0
2006-03-10,34799,34799,0,1,0.0,-29862.0
2006-03-11,34799,34799,0,0,0.0,-29862.0
2006-03-12,34799,35003,204,-1,-204.0,-30066.0
2006-03-13,35003,34391,-612,-1,612.0,-29454.0
2006-03-14,34391,35513,1122,-1,-1122.0,-30576.0
2006-03-15,35513,36738,1225,0,0.0,-30576.0
2006-03-16,36738,37554,816,1,816.0,-29760.0
2006-03-17,37554,37554,0,-1,-0.0,-29760.0
2006-03-18,37554,37554,0,1,0.0,-29760.0
2006-03-19,37554,37401,-153,1,-153.0,-29913.0
2006-03-20,37401,36227,-1174,-1,1174.0,-28739.0
2006-03-21,36227,34595,-1632,-1,1632.0,-27107.0
2006-03-22,34595,34135,-460,-1,460.0,-26647.0
2006-03-23,34135,35105,970,1,970.0,-25677.0
2006-03-24,35105,35105,0,1,0.0,-25677.0
2006-03-25,35105,35105,0,1,0.0,-25677.0
2006-03-26,35105,35207,102,-1,-102.0,-25779.0
2006-03-27,35207,34697,-510,0,-0.0,-25779.0
2006-03-28,34697,34697,0,-1,-0.0,-25779.0
2006-03-29,34697,36176,1479,0,0.0,-25779.0
2006-03-30,36176,37248,1072,-1,-1072.0,-26851.0
2006-03-31,37248,37248,0,-1,-0.0,-26851.0
2006-04-01,37248,37248,0,0,0.0,-26851.0
2006-04-02,37248,36278,-970,-1,970.0,-25881.0
2006-04-03,36278,34799,-1479,-1,1479.0,-24402.0
2006-04-04,34799,35309,510,1,510.0,-23892.0
2006-04-05,35309,34391,-918,0,-0.0,-23892.0
2006-04-06,34391,35105,714,0,0.0,-23892.0
2006-04-07,35105,35105,0,0,0.0,-23892.0
2006-04-08,35105,35105,0,1,0.0,-23892.0
2006-04-09,35105,34493,-612,0,-0.0,-23892.0
2006-04-10,34493,33574,-919,0,-0.0,-23892.0
2006-04-11,33574,33421,-153,-1,153.0,-23739.0
2006-04-12,33421,33982,561,0,0.0,-23739.0
2006-04-13,33982,36789,2807,1,2807.0,-20932.0
2006-04-14,36789,36789,0,-1,-0.0,-20932.0
2006-04-15,36789,36789,0,1,0.0,-20932.0
2006-04-16,36789,36738,-51,-1,51.0,-20881.0
2006-04-17,36738,38064,1326,1,1326.0,-19555.0
2006-04-18,38064,36942,-1122,0,-0.0,-19555.0
2006-04-19,36942,37044,102,1,102.0,-19453.0
2006-04-20,37044,39697,2653,-1,-2653.0,-22106.0
2006-04-21,39697,39697,0,1,0.0,-22106.0
2006-04-22,39697,39697,0,0,0.0,-22106.0
2006-04-23,39697,39187,-510,0,-0.0,-22106.0
2006-04-24,39187,39187,0,0,0.0,-22106.0
2006-04-25,39187,39289,102,-1,-102.0,-22208.0
2006-04-26,39289,38524,-765,1,-765.0,-22973.0
2006-04-27,38524,36278,-2246,0,-0.0,-22973.0
2006-04-28,36278,36278,0,-1,-0.0,-22973.0
2006-04-29,36278,36278,0,1,0.0,-22973.0
2006-04-30,36278,36278,0,1,0.0,-22973.0
2006-05-01,36278,35717,-561,-1,561.0,-22412.0
2006-05-02,35717,35105,-612,0,-0.0,-22412.0
2006-05-03,35105,34595,-510,0,-0.0,-22412.0
2006-05-04,34595,34595,0,1,0.0,-22412.0
2006-05-05,34595,34595,0,-1,-0.0,-22412.0
2006-05-06,34595,34595,0,-1,-0.0,-22412.0
2006-05-07,34595,36278,1683,0,0.0,-22412.0
2006-05-08,36278,35717,-561,0,-0.0,-22412.0
2006-05-09,35717,36125,408,1,408.0,-22004.0
2006-05-10,36125,36534,409,1,409.0,-21595.0
2006-05-11,36534,35513,-1021,-1,1021.0,-20574.0
2006-05-12,35513,35513,0,-1,-0.0,-20574.0
2006-05-13,35513,35513,0,0,0.0,-20574.0
2006-05-14,35513,33574,-1939,1,-1939.0,-22513.0
2006-05-15,33574,32197,-1377,-1,1377.0,-21136.0
2006-05-16,32197,31584,-613,-1,613.0,-20523.0
2006-05-17,31584,32197,613,0,0.0,-20523.0
2006-05-18,32197,31431,-766,1,-766.0,-21289.0
2006-05-19,31431,31431,0,0,0.0,-21289.0
2006-05-20,31431,31431,0,-1,-0.0,-21289.0
2006-05-21,31431,30002,-1429,0,-0.0,-21289.0
2006-05-22,30002,30207,205,1,205.0,-21084.0
2006-05-23,30207,30615,408,-1,-408.0,-21492.0
2006-05-24,30615,30156,-459,0,-0.0,-21492.0
2006-05-25,30156,30615,459,0,0.0,-21492.0
2006-05-26,30615,30615,0,-1,-0.0,-21492.0
2006-05-27,30615,30615,0,0,0.0,-21492.0
2006-05-28,30615,31023,408,0,0.0,-21492.0
2006-05-29,31023,30513,-510,1,-510.0,-22002.0
2006-05-30,30513,30513,0,1,0.0,-22002.0
2006-05-31,30513,30053,-460,0,-0.0,-22002.0
2006-06-01,30053,30615,562,1,562.0,-21440.0
2006-06-02,30615,30615,0,-1,-0.0,-21440.0
2006-06-03,30615,30615,0,0,0.0,-21440.0
2006-06-04,30615,30207,-408,-1,408.0,-21032.0
2006-06-05,30207,30207,0,0,0.0,-21032.0
2006-06-06,30207,28064,-2143,1,-2143.0,-23175.0
2006-06-07,28064,28064,0,-1,-0.0,-23175.0
2006-06-08,28064,29594,1530,1,1530.0,-21645.0
2006-06-09,29594,29594,0,0,0.0,-21645.0
2006-06-10,29594,29594,0,1,0.0,-21645.0
2006-06-11,29594,29543,-51,0,-0.0,-21645.0
2006-06-12,29543,27349,-2194,-1,2194.0,-19451.0
2006-06-13,27349,27553,204,-1,-204.0,-19655.0
2006-06-14,27553,26992,-561,-1,561.0,-19094.0
2006-06-15,26992,27910,918,-1,-918.0,-20012.0
2006-06-16,27910,27910,0,0,0.0,-20012.0
2006-06-17,27910,27910,0,-1,-0.0,-20012.0
2006-06-18,27910,27553,-357,-1,357.0,-19655.0
2006-06-19,27553,26839,-714,1,-714.0,-20369.0
2006-06-20,26839,26635,-204,1,-204.0,-20573.0
2006-06-21,26635,27451,816,0,0.0,-20573.0
2006-06-22,27451,27247,-204,-1,204.0,-20369.0
2006-06-23,27247,27247,0,0,0.0,-20369.0
2006-06-24,27247,27247,0,0,0.0,-20369.0
2006-06-25,27247,27553,306,1,306.0,-20063.0
2006-06-26,27553,27400,-153,-1,153.0,-19910.0
2006-06-27,27400,28574,1174,-1,-1174.0,-21084.0
2006-06-28,28574,29594,1020,1,1020.0,-20064.0
2006-06-29,29594,31023,1429,1,1429.0,-18635.0
2006-06-30,31023,31023,0,-1,-0.0,-18635.0
2006-07-01,31023,31023,0,1,0.0,-18635.0
2006-07-02,31023,30666,-357,1,-357.0,-18992.0
2006-07-03,30666,30053,-613,-1,613.0,-18379.0
2006-07-04,30053,30053,0,-1,-0.0,-18379.0
2006-07-05,30053,30615,562,-1,-562.0,-18941.0
2006-07-06,30615,33013,2398,-1,-2398.0,-21339.0
2006-07-07,33013,33013,0,1,0.0,-21339.0
2006-07-08,33013,33013,0,1,0.0,-21339.0
2006-07-09,33013,33472,459,1,459.0,-20880.0
2006-07-10,33472,32656,-816,1,-816.0,-21696.0
2006-07-11,32656,32248,-408,-1,408.0,-21288.0
2006-07-12,32248,31737,-511,-1,511.0,-20777.0
2006-07-13,31737,31584,-153,0,-0.0,-20777.0
2006-07-14,31584,31584,0,-1,-0.0,-20777.0
2006-07-15,31584,31584,0,-1,-0.0,-20777.0
2006-07-16,31584,31584,0,0,0.0,-20777.0
2006-07-17,31584,31431,-153,0,-0.0,-20777.0
2006-07-18,31431,31941,510,0,0.0,-20777.0
2006-07-19,31941,32656,715,1,715.0,-20062.0
2006-07-20,32656,32248,-408,-1,408.0,-19654.0
2006-07-21,32248,32248,0,0,0.0,-19654.0
2006-07-22,32248,32248,0,1,0.0,-19654.0
2006-07-23,32248,32860,612,-1,-612.0,-20266.0
2006-07-24,32860,34186,1326,0,0.0,-20266.0
2006-07-25,34186,34697,511,1,511.0,-19755.0
2006-07-26,34697,34391,-306,0,-0.0,-19755.0
2006-07-27,34391,34799,408,-1,-408.0,-20163.0
2006-07-28,34799,34799,0,-1,-0.0,-20163.0
2006-07-29,34799,34799,0,1,0.0,-20163.0
2006-07-30,34799,34595,-204,1,-204.0,-20367.0
2006-07-31,34595,34289,-306,-1,306.0,-20061.0
2006-08-01,34289,33676,-613,1,-613.0,-20674.0
2006-08-02,33676,34084,408,1,408.0,-20266.0
2006-08-03,34084,34238,154,-1,-154.0,-20420.0
2006-08-04,34238,34238,0,-1,-0.0,-20420.0
2006-08-05,34238,34238,0,-1,-0.0,-20420.0
2006-08-06,34238,34084,-154,0,-0.0,-20420.0
2006-08-07,34084,34238,154,0,0.0,-20420.0
2006-08-08,34238,34186,-52,1,-52.0,-20472.0
2006-08-09,34186,33727,-459,-1,459.0,-20013.0
2006-08-10,33727,32962,-765,-1,765.0,-19248.0
2006-08-11,32962,32962,0,-1,-0.0,-19248.0
2006-08-12,32962,32962,0,-1,-0.0,-19248.0
2006-08-13,32962,31941,-1021,0,-0.0,-19248.0
2006-08-14,31941,31941,0,0,0.0,-19248.0
2006-08-15,31941,33115,1174,-1,-1174.0,-20422.0
2006-08-16,33115,34289,1174,-1,-1174.0,-21596.0
2006-08-17,34289,34646,357,-1,-357.0,-21953.0
2006-08-18,34646,34646,0,1,0.0,-21953.0
2006-08-19,34646,34646,0,0,0.0,-21953.0
2006-08-20,34646,33370,-1276,-1,1276.0,-20677.0
2006-08-21,33370,34391,1021,-1,-1021.0,-21698.0
2006-08-22,34391,34595,204,-1,-204.0,-21902.0
2006-08-23,34595,34748,153,0,0.0,-21902.0
2006-08-24,34748,35360,612,0,0.0,-21902.0
2006-08-25,35360,35360,0,0,0.0,-21902.0
2006-08-26,35360,35360,0,1,0.0,-21902.0
2006-08-27,35360,35360,0,0,0.0,-21902.0
2006-08-28,35360,35717,357,0,0.0,-21902.0
2006-08-29,35717,36942,1225,0,0.0,-21902.0
2006-08-30,36942,36840,-102,0,-0.0,-21902.0
2006-08-31,36840,36330,-510,-1,510.0,-21392.0
2006-09-01,36330,36330,0,0,0.0,-21392.0
2006-09-02,36330,36330,0,1,0.0,-21392.0
2006-09-03,36330,35972,-358,-1,358.0,-21034.0
2006-09-04,35972,36023,51,0,0.0,-21034.0
2006-09-05,36023,35411,-612,-1,612.0,-20422.0
2006-09-06,35411,36125,714,0,0.0,-20422.0
2006-09-07,36125,36534,409,0,0.0,-20422.0
2006-09-08,36534,36534,0,1,0.0,-20422.0
2006-09-09,36534,36534,0,1,0.0,-20422.0
2006-09-10,36534,36534,0,1,0.0,-20422.0
2006-09-11,36534,36636,102,1,102.0,-20320.0
2006-09-12,36636,35870,-766,1,-766.0,-21086.0
2006-09-13,35870,37044,1174,1,1174.0,-19912.0
2006-09-14,37044,36840,-204,-1,204.0,-19708.0
2006-09-15,36840,36840,0,1,0.0,-19708.0
2006-09-16,36840,36840,0,1,0.0,-19708.0
2006-09-17,36840,37554,714,-1,-714.0,-20422.0
2006-09-18,37554,38268,714,-1,-714.0,-21136.0
2006-09-19,38268,38064,-204,-1,204.0,-20932.0
2006-09-20,38064,38166,102,-1,-102.0,-21034.0
2006-09-21,38166,37299,-867,-1,867.0,-20167.0
2006-09-22,37299,37299,0,0,0.0,-20167.0
2006-09-23,37299,37299,0,-1,-0.0,-20167.0
2006-09-24,37299,38524,1225,-1,-1225.0,-21392.0
2006-09-25,38524,40258,1734,-1,-1734.0,-23126.0
2006-09-26,40258,40820,562,-1,-562.0,-23688.0
2006-09-27,40820,41840,1020,0,0.0,-23688.0
2006-09-28,41840,42350,510,-1,-510.0,-24198.0
2006-09-29,42350,42350,0,0,0.0,-24198.0
2006-09-30,42350,42350,0,-1,-0.0,-24198.0
2006-10-01,42350,41687,-663,1,-663.0,-24861.0
2006-10-02,41687,41687,0,1,0.0,-24861.0
2006-10-03,41687,40054,-1633,0,-0.0,-24861.0
2006-10-04,40054,40054,0,0,0.0,-24861.0
2006-10-05,40054,40054,0,0,0.0,-24861.0
2006-10-06,40054,40054,0,1,0.0,-24861.0
2006-10-07,40054,40054,0,0,0.0,-24861.0
2006-10-08,40054,38830,-1224,-1,1224.0,-23637.0
2006-10-09,38830,40207,1377,1,1377.0,-22260.0
2006-10-10,40207,40820,613,0,0.0,-22260.0
2006-10-11,40820,41330,510,0,0.0,-22260.0
2006-10-12,41330,41330,0,-1,-0.0,-22260.0
2006-10-13,41330,41330,0,0,0.0,-22260.0
2006-10-14,41330,41330,0,-1,-0.0,-22260.0
2006-10-15,41330,40820,-510,1,-510.0,-22770.0
2006-10-16,40820,40718,-102,1,-102.0,-22872.0
2006-10-17,40718,40463,-255,-1,255.0,-22617.0
2006-10-18,40463,39799,-664,1,-664.0,-23281.0
2006-10-19,39799,40207,408,1,408.0,-22873.0
2006-10-20,40207,40207,0,-1,-0.0,-22873.0
2006-10-21,40207,40207,0,1,0.0,-22873.0
2006-10-22,40207,39799,-408,-1,408.0,-22465.0
2006-10-23,39799,39289,-510,1,-510.0,-22975.0
2006-10-24,39289,39901,612,1,612.0,-22363.0
2006-10-25,39901,39799,-102,0,-0.0,-22363.0
2006-10-26,39799,40718,919,-1,-919.0,-23282.0
2006-10-27,40718,40718,0,-1,-0.0,-23282.0
2006-10-28,40718,40718,0,1,0.0,-23282.0
2006-10-29,40718,40820,102,0,0.0,-23282.0
2006-10-30,40820,42248,1428,0,0.0,-23282.0
2006-10-31,42248,43728,1480,-1,-1480.0,-24762.0
2006-11-01,43728,44289,561,1,561.0,-24201.0
2006-11-02,44289,44544,255,0,0.0,-24201.0
2006-11-03,44544,44544,0,-1,-0.0,-24201.0
2006-11-04,44544,44544,0,-1,-0.0,-24201.0
2006-11-05,44544,46432,1888,1,1888.0,-22313.0
2006-11-06,46432,46739,307,1,307.0,-22006.0
2006-11-07,46739,44595,-2144,-1,2144.0,-19862.0
2006-11-08,44595,44595,0,-1,-0.0,-19862.0
2006-11-09,44595,44902,307,1,307.0,-19555.0
2006-11-10,44902,44902,0,1,0.0,-19555.0
2006-11-11,44902,44902,0,-1,-0.0,-19555.0
2006-11-12,44902,44340,-562,1,-562.0,-20117.0
2006-11-13,44340,44800,460,1,460.0,-19657.0
2006-11-14,44800,45718,918,-1,-918.0,-20575.0
2006-11-15,45718,46228,510,-1,-510.0,-21085.0
2006-11-16,46228,48065,1837,0,0.0,-21085.0
2006-11-17,48065,48065,0,1,0.0,-21085.0
2006-11-18,48065,48065,0,0,0.0,-21085.0
2006-11-19,48065,49698,1633,0,0.0,-21085.0
2006-11-20,49698,50514,816,-1,-816.0,-21901.0
2006-11-21,50514,51025,511,-1,-511.0,-22412.0
2006-11-22,51025,51025,0,-1,-0.0,-22412.0
2006-11-23,51025,52555,1530,0,0.0,-22412.0
2006-11-24,52555,52555,0,-1,-0.0,-22412.0
2006-11-25,52555,52555,0,-1,-0.0,-22412.0
2006-11-26,52555,52045,-510,1,-510.0,-22922.0
2006-11-27,52045,50923,-1122,-1,1122.0,-21800.0
2006-11-28,50923,51841,918,-1,-918.0,-22718.0
2006-11-29,51841,52861,1020,-1,-1020.0,-23738.0
2006-11-30,52861,54494,1633,1,1633.0,-22105.0
2006-12-01,54494,54494,0,1,0.0,-22105.0
2006-12-02,54494,54494,0,1,0.0,-22105.0
2006-12-03,54494,54596,102,-1,-102.0,-22207.0
2006-12-04,54596,54086,-510,1,-510.0,-22717.0
2006-12-05,54086,53168,-918,1,-918.0,-23635.0
2006-12-06,53168,52861,-307,-1,307.0,-23328.0
2006-12-07,52861,54086,1225,-1,-1225.0,-24553.0
2006-12-08,54086,54086,0,0,0.0,-24553.0
2006-12-09,54086,54086,0,0,0.0,-24553.0
2006-12-10,54086,53372,-714,1,-714.0,-25267.0
2006-12-11,53372,52861,-511,0,-0.0,-25267.0
2006-12-12,52861,53066,205,-1,-205.0,-25472.0
2006-12-13,53066,54596,1530,1,1530.0,-23942.0
2006-12-14,54596,52657,-1939,1,-1939.0,-25881.0
2006-12-15,52657,52657,0,-1,-0.0,-25881.0
2006-12-16,52657,52657,0,1,0.0,-25881.0
2006-12-17,52657,53066,409,1,409.0,-25472.0
2006-12-18,53066,52249,-817,1,-817.0,-26289.0
2006-12-19,52249,55107,2858,0,0.0,-26289.0
2006-12-20,55107,54392,-715,0,-0.0,-26289.0
2006-12-21,54392,55311,919,0,0.0,-26289.0
2006-12-22,55311,55311,0,1,0.0,-26289.0
2006-12-23,55311,55311,0,1,0.0,-26289.0
2006-12-24,55311,55311,0,-1,-0.0,-26289.0
2006-12-25,55311,55209,-102,1,-102.0,-26391.0
2006-12-26,55209,56637,1428,1,1428.0,-24963.0
2006-12-27,56637,58066,1429,-1,-1429.0,-26392.0
2006-12-28,58066,58066,0,1,0.0,-26392.0
2006-12-29,58066,58066,0,0,0.0,-26392.0
2006-12-30,58066,58066,0,0,0.0,-26392.0
2006-12-31,58066,58066,0,0,0.0,-26392.0
2007-01-01,58066,58372,306,1,306.0,-26086.0
2007-01-02,58372,58474,102,1,102.0,-25984.0
2007-01-03,58474,57148,-1326,0,-0.0,-25984.0
2007-01-04,57148,56637,-511,1,-511.0,-26495.0
2007-01-05,56637,56637,0,0,0.0,-26495.0
2007-01-06,56637,56637,0,-1,-0.0,-26495.0
2007-01-07,56637,55617,-1020,0,-0.0,-26495.0
2007-01-08,55617,54290,-1327,1,-1327.0,-27822.0
2007-01-09,54290,52453,-1837,0,-0.0,-27822.0
2007-01-10,52453,53066,613,0,0.0,-27822.0
2007-01-11,53066,55107,2041,1,2041.0,-25781.0
2007-01-12,55107,55107,0,-1,-0.0,-25781.0
2007-01-13,55107,55107,0,0,0.0,-25781.0
2007-01-14,55107,57250,2143,1,2143.0,-23638.0
2007-01-15,57250,56331,-919,0,-0.0,-23638.0
2007-01-16,56331,55515,-816,0,-0.0,-23638.0
2007-01-17,55515,56229,714,0,0.0,-23638.0
2007-01-18,56229,55923,-306,0,-0.0,-23638.0
2007-01-19,55923,55923,0,1,0.0,-23638.0
2007-01-20,55923,55923,0,1,0.0,-23638.0
2007-01-21,55923,56637,714,0,0.0,-23638.0
2007-01-22,56637,57658,1021,-1,-1021.0,-24659.0
2007-01-23,57658,56127,-1531,0,-0.0,-24659.0
2007-01-24,56127,56127,0,1,0.0,-24659.0
2007-01-25,56127,55107,-1020,1,-1020.0,-25679.0
2007-01-26,55107,55107,0,-1,-0.0,-25679.0
2007-01-27,55107,55107,0,0,0.0,-25679.0
2007-01-28,55107,52657,-2450,0,-0.0,-25679.0
2007-01-29,52657,53984,1327,-1,-1327.0,-27006.0
2007-01-30,53984,53780,-204,1,-204.0,-27210.0
2007-01-31,53780,53168,-612,-1,612.0,-26598.0
2007-02-01,53168,53372,204,0,0.0,-26598.0
2007-02-02,53372,53372,0,-1,-0.0,-26598.0
2007-02-03,53372,53372,0,0,0.0,-26598.0
2007-02-04,53372,53168,-204,0,-0.0,-26598.0
2007-02-05,53168,54086,918,0,0.0,-26598.0
2007-02-06,54086,54494,408,-1,-408.0,-27006.0
2007-02-07,54494,54698,204,-1,-204.0,-27210.0
2007-02-08,54698,54086,-612,-1,612.0,-26598.0
2007-02-09,54086,54086,0,0,0.0,-26598.0
2007-02-10,54086,54086,0,-1,-0.0,-26598.0
2007-02-11,54086,52861,-1225,-1,1225.0,-25373.0
2007-02-12,52861,52045,-816,-1,816.0,-24557.0
2007-02-13,52045,52759,714,1,714.0,-23843.0
2007-02-14,52759,53372,613,0,0.0,-23843.0
2007-02-15,53372,53780,408,1,408.0,-23435.0
2007-02-16,53780,53780,0,1,0.0,-23435.0
2007-02-17,53780,53780,0,-1,-0.0,-23435.0
2007-02-18,53780,53780,0,-1,-0.0,-23435.0
2007-02-19,53780,53576,-204,0,-0.0,-23435.0
2007-02-20,53576,52964,-612,-1,612.0,-22823.0
2007-02-21,52964,52045,-919,0,-0.0,-22823.0
2007-02-22,52045,55107,3062,1,3062.0,-19761.0
2007-02-23,55107,55107,0,0,0.0,-19761.0
2007-02-24,55107,55107,0,1,0.0,-19761.0
2007-02-25,55107,58984,3877,1,3877.0,-15884.0
2007-02-26,58984,59699,715,0,0.0,-15884.0
2007-02-27,59699,58984,-715,-1,715.0,-15169.0
2007-02-28,58984,58984,0,0,0.0,-15169.0
2007-03-01,58984,58372,-612,-1,612.0,-14557.0
2007-03-02,58372,58372,0,1,0.0,-14557.0
2007-03-03,58372,58372,0,1,0.0,-14557.0
2007-03-04,58372,57964,-408,0,-0.0,-14557.0
2007-03-05,57964,62658,4694,0,0.0,-14557.0
2007-03-06,62658,62148,-510,0,-0.0,-14557.0
2007-03-07,62148,64291,2143,0,0.0,-14557.0
2007-03-08,64291,65822,1531,0,0.0,-14557.0
2007-03-09,65822,65822,0,0,0.0,-14557.0
2007-03-10,65822,65822,0,0,0.0,-14557.0
2007-03-11,65822,65516,-306,1,-306.0,-14863.0
2007-03-12,65516,65822,306,-1,-306.0,-15169.0
2007-03-13,65822,67352,1530,1,1530.0,-13639.0
2007-03-14,67352,69393,2041,-1,-2041.0,-15680.0
2007-03-15,69393,70618,1225,-1,-1225.0,-16905.0
2007-03-16,70618,70618,0,-1,-0.0,-16905.0
2007-03-17,70618,70618,0,-1,-0.0,-16905.0
2007-03-18,70618,69393,-1225,1,-1225.0,-18130.0
2007-03-19,69393,70414,1021,0,0.0,-18130.0
2007-03-20,70414,70312,-102,-1,102.0,-18028.0
2007-03-21,70312,74496,4184,1,4184.0,-13844.0
2007-03-22,74496,82150,7654,0,0.0,-13844.0
2007-03-23,82150,82150,0,1,0.0,-13844.0
2007-03-24,82150,82150,0,0,0.0,-13844.0
2007-03-25,82150,78068,-4082,-1,4082.0,-9762.0
2007-03-26,78068,78578,510,1,510.0,-9252.0
2007-03-27,78578,76129,-2449,1,-2449.0,-11701.0
2007-03-28,76129,79088,2959,-1,-2959.0,-14660.0
2007-03-29,79088,78578,-510,1,-510.0,-15170.0
2007-03-30,78578,78578,0,-1,-0.0,-15170.0
2007-03-31,78578,78578,0,1,0.0,-15170.0
2007-04-01,78578,80619,2041,-1,-2041.0,-17211.0
2007-04-02,80619,79802,-817,1,-817.0,-18028.0
2007-04-03,79802,79598,-204,1,-204.0,-18232.0
2007-04-04,79598,77659,-1939,1,-1939.0,-20171.0
2007-04-05,77659,78680,1021,-1,-1021.0,-21192.0
2007-04-06,78680,78680,0,-1,-0.0,-21192.0
2007-04-07,78680,78680,0,1,0.0,-21192.0
2007-04-08,78680,81537,2857,-1,-2857.0,-24049.0
2007-04-09,81537,85313,3776,1,3776.0,-20273.0
2007-04-10,85313,82150,-3163,-1,3163.0,-17110.0
2007-04-11,82150,79905,-2245,-1,2245.0,-14865.0
2007-04-12,79905,83374,3469,-1,-3469.0,-18334.0
2007-04-13,83374,83374,0,0,0.0,-18334.0
2007-04-14,83374,83374,0,1,0.0,-18334.0
2007-04-15,83374,86742,3368,-1,-3368.0,-21702.0
2007-04-16,86742,86232,-510,-1,510.0,-21192.0
2007-04-17,86232,88068,1836,1,1836.0,-19356.0
2007-04-18,88068,85619,-2449,-1,2449.0,-16907.0
2007-04-19,85619,89497,3878,1,3878.0,-13029.0
2007-04-20,89497,89497,0,-1,-0.0,-13029.0
2007-04-21,89497,89497,0,-1,-0.0,-13029.0
2007-04-22,89497,91334,1837,0,0.0,-13029.0
2007-04-23,91334,93375,2041,-1,-2041.0,-15070.0
2007-04-24,93375,93375,0,-1,-0.0,-15070.0
2007-04-25,93375,89803,-3572,-1,3572.0,-11498.0
2007-04-26,89803,85721,-4082,-1,4082.0,-7416.0
2007-04-27,85721,85721,0,-1,-0.0,-7416.0
2007-04-28,85721,85721,0,0,0.0,-7416.0
2007-04-29,85721,88273,2552,0,0.0,-7416.0
2007-04-30,88273,88273,0,1,0.0,-7416.0
2007-05-01,88273,85823,-2450,1,-2450.0,-9866.0
2007-05-02,85823,83578,-2245,-1,2245.0,-7621.0
2007-05-03,83578,92252,8674,-1,-8674.0,-16295.0
2007-05-04,92252,92252,0,1,0.0,-16295.0
2007-05-05,92252,92252,0,-1,-0.0,-16295.0
2007-05-06,92252,92763,511,-1,-511.0,-16806.0
2007-05-07,92763,97457,4694,1,4694.0,-12112.0
2007-05-08,97457,105111,7654,-1,-7654.0,-19766.0
2007-05-09,105111,109193,4082,-1,-4082.0,-23848.0
2007-05-10,109193,115316,6123,-1,-6123.0,-29971.0
2007-05-11,115316,115316,0,0,0.0,-29971.0
2007-05-12,115316,115316,0,-1,-0.0,-29971.0
2007-05-13,115316,116336,1020,1,1020.0,-28951.0
2007-05-14,116336,107152,-9184,-1,9184.0,-19767.0
2007-05-15,107152,108172,1020,0,0.0,-19767.0
2007-05-16,108172,111744,3572,0,0.0,-19767.0
2007-05-17,111744,116846,5102,0,0.0,-19767.0
2007-05-18,116846,116846,0,-1,-0.0,-19767.0
2007-05-19,116846,116846,0,1,0.0,-19767.0
2007-05-20,116846,120418,3572,0,0.0,-19767.0
2007-05-21,120418,120418,0,1,0.0,-19767.0
2007-05-22,120418,118377,-2041,0,-0.0,-19767.0
2007-05-23,118377,118377,0,0,0.0,-19767.0
2007-05-24,118377,121949,3572,0,0.0,-19767.0
2007-05-25,121949,121949,0,-1,-0.0,-19767.0
2007-05-26,121949,121949,0,1,0.0,-19767.0
2007-05-27,121949,122459,510,0,0.0,-19767.0
2007-05-28,122459,126031,3572,1,3572.0,-16195.0
2007-05-29,126031,126541,510,-1,-510.0,-16705.0
2007-05-30,126541,135725,9184,-1,-9184.0,-25889.0
2007-05-31,135725,126541,-9184,-1,9184.0,-16705.0
2007-06-01,126541,126541,0,0,0.0,-16705.0
2007-06-02,126541,126541,0,-1,-0.0,-16705.0
2007-06-03,126541,132154,5613,0,0.0,-16705.0
2007-06-04,132154,130113,-2041,1,-2041.0,-18746.0
2007-06-05,130113,130113,0,-1,-0.0,-18746.0
2007-06-06,130113,132664,2551,-1,-2551.0,-21297.0
2007-06-07,132664,127561,-5103,1,-5103.0,-26400.0
2007-06-08,127561,127561,0,1,0.0,-26400.0
2007-06-09,127561,127561,0,0,0.0,-26400.0
2007-06-10,127561,121949,-5612,1,-5612.0,-32012.0
2007-06-11,121949,116336,-5613,-1,5613.0,-26399.0
2007-06-12,116336,121439,5103,-1,-5103.0,-31502.0
2007-06-13,121439,139297,17858,-1,-17858.0,-49360.0
2007-06-14,139297,153074,13777,-1,-13777.0,-63137.0
2007-06-15,153074,153074,0,0,0.0,-63137.0
2007-06-16,153074,153074,0,-1,-0.0,-63137.0
2007-06-17,153074,147971,-5103,-1,5103.0,-58034.0
2007-06-18,147971,156135,8164,-1,-8164.0,-66198.0
2007-06-19,156135,150523,-5612,0,-0.0,-66198.0
2007-06-20,150523,150012,-511,-1,511.0,-65687.0
2007-06-21,150012,145930,-4082,0,-0.0,-65687.0
2007-06-22,145930,145930,0,-1,-0.0,-65687.0
2007-06-23,145930,145930,0,-1,-0.0,-65687.0
2007-06-24,145930,142359,-3571,-1,3571.0,-62116.0
2007-06-25,142359,140828,-1531,0,-0.0,-62116.0
2007-06-26,140828,150012,9184,0,0.0,-62116.0
2007-06-27,150012,145930,-4082,0,-0.0,-62116.0
2007-06-28,145930,146951,1021,-1,-1021.0,-63137.0
2007-06-29,146951,146951,0,0,0.0,-63137.0
2007-06-30,146951,146951,0,0,0.0,-63137.0
2007-07-01,146951,145930,-1021,0,-0.0,-63137.0
2007-07-02,145930,147971,2041,1,2041.0,-61096.0
2007-07-03,147971,156645,8674,-1,-8674.0,-69770.0
2007-07-04,156645,164299,7654,0,0.0,-69770.0
2007-07-05,164299,157156,-7143,0,-0.0,-69770.0
2007-07-06,157156,157156,0,1,0.0,-69770.0
2007-07-07,157156,157156,0,-1,-0.0,-69770.0
2007-07-08,157156,160217,3061,0,0.0,-69770.0
2007-07-09,160217,161748,1531,1,1531.0,-68239.0
2007-07-10,161748,161238,-510,-1,510.0,-67729.0
2007-07-11,161238,157156,-4082,-1,4082.0,-63647.0
2007-07-12,157156,161238,4082,0,0.0,-63647.0
2007-07-13,161238,161238,0,-1,-0.0,-63647.0
2007-07-14,161238,161238,0,1,0.0,-63647.0
2007-07-15,161238,157156,-4082,0,-0.0,-63647.0
2007-07-16,157156,157156,0,1,0.0,-63647.0
2007-07-17,157156,162258,5102,0,0.0,-63647.0
2007-07-18,162258,163279,1021,-1,-1021.0,-64668.0
2007-07-19,163279,169402,6123,1,6123.0,-58545.0
2007-07-20,169402,169402,0,-1,-0.0,-58545.0
2007-07-21,169402,169402,0,1,0.0,-58545.0
2007-07-22,169402,164299,-5103,-1,5103.0,-53442.0
2007-07-23,164299,162258,-2041,-1,2041.0,-51401.0
2007-07-24,162258,164299,2041,-1,-2041.0,-53442.0
2007-07-25,164299,153074,-11225,-1,11225.0,-42217.0
2007-07-26,153074,152053,-1021,0,-0.0,-42217.0
2007-07-27,152053,152053,0,-1,-0.0,-42217.0
2007-07-28,152053,152053,0,0,0.0,-42217.0
2007-07-29,152053,152053,0,1,0.0,-42217.0
2007-07-30,152053,158176,6123,-1,-6123.0,-48340.0
2007-07-31,158176,148482,-9694,1,-9694.0,-58034.0
2007-08-01,148482,144400,-4082,-1,4082.0,-53952.0
2007-08-02,144400,141338,-3062,1,-3062.0,-57014.0
2007-08-03,141338,141338,0,-1,-0.0,-57014.0
2007-08-04,141338,141338,0,-1,-0.0,-57014.0
2007-08-05,141338,141338,0,1,0.0,-57014.0
2007-08-06,141338,145930,4592,-1,-4592.0,-61606.0
2007-08-07,145930,151033,5103,1,5103.0,-56503.0
2007-08-08,151033,151033,0,0,0.0,-56503.0
2007-08-09,151033,143889,-7144,-1,7144.0,-49359.0
2007-08-10,143889,143889,0,-1,-0.0,-49359.0
2007-08-11,143889,143889,0,1,0.0,-49359.0
2007-08-12,143889,138787,-5102,1,-5102.0,-54461.0
2007-08-13,138787,138787,0,-1,-0.0,-54461.0
2007-08-14,138787,138787,0,0,0.0,-54461.0
2007-08-15,138787,135215,-3572,1,-3572.0,-58033.0
2007-08-16,135215,125520,-9695,-1,9695.0,-48338.0
2007-08-17,125520,125520,0,1,0.0,-48338.0
2007-08-18,125520,125520,0,-1,-0.0,-48338.0
2007-08-19,125520,128582,3062,0,0.0,-48338.0
2007-08-20,128582,129602,1020,0,0.0,-48338.0
2007-08-21,129602,135215,5613,-1,-5613.0,-53951.0
2007-08-22,135215,139297,4082,0,0.0,-53951.0
2007-08-23,139297,141338,2041,1,2041.0,-51910.0
2007-08-24,141338,141338,0,-1,-0.0,-51910.0
2007-08-25,141338,141338,0,0,0.0,-51910.0
2007-08-26,141338,137766,-3572,-1,3572.0,-48338.0
2007-08-27,137766,143379,5613,-1,-5613.0,-53951.0
2007-08-28,143379,148482,5103,1,5103.0,-48848.0
2007-08-29,148482,146441,-2041,-1,2041.0,-46807.0
2007-08-30,146441,152053,5612,1,5612.0,-41195.0
2007-08-31,152053,152053,0,0,0.0,-41195.0
2007-09-01,152053,152053,0,0,0.0,-41195.0
2007-09-02,152053,153074,1021,0,0.0,-41195.0
2007-09-03,153074,150012,-3062,1,-3062.0,-44257.0
2007-09-04,150012,150012,0,-1,-0.0,-44257.0
2007-09-05,150012,153074,3062,-1,-3062.0,-47319.0
2007-09-06,153074,155625,2551,-1,-2551.0,-49870.0
2007-09-07,155625,155625,0,-1,-0.0,-49870.0
2007-09-08,155625,155625,0,-1,-0.0,-49870.0
2007-09-09,155625,152053,-3572,-1,3572.0,-46298.0
2007-09-10,152053,153074,1021,0,0.0,-46298.0
2007-09-11,153074,157666,4592,1,4592.0,-41706.0
2007-09-12,157666,171443,13777,1,13777.0,-27929.0
2007-09-13,171443,179607,8164,0,0.0,-27929.0
2007-09-14,179607,179607,0,0,0.0,-27929.0
2007-09-15,179607,179607,0,0,0.0,-27929.0
2007-09-16,179607,178076,-1531,-1,1531.0,-26398.0
2007-09-17,178076,175525,-2551,-1,2551.0,-23847.0
2007-09-18,175525,183178,7653,1,7653.0,-16194.0
2007-09-19,183178,199506,16328,-1,-16328.0,-32522.0
2007-09-20,199506,198996,-510,0,-0.0,-32522.0
2007-09-21,198996,198996,0,-1,-0.0,-32522.0
2007-09-22,198996,198996,0,1,0.0,-32522.0
2007-09-23,198996,198996,0,-1,-0.0,-32522.0
2007-09-24,198996,198996,0,-1,-0.0,-32522.0
2007-09-25,198996,198996,0,-1,-0.0,-32522.0
2007-09-26,198996,199506,510,1,510.0,-32012.0
2007-09-27,199506,193893,-5613,-1,5613.0,-26399.0
2007-09-28,193893,193893,0,0,0.0,-26399.0
2007-09-29,193893,193893,0,0,0.0,-26399.0
2007-09-30,193893,198486,4593,0,0.0,-26399.0
2007-10-01,198486,207160,8674,1,8674.0,-17725.0
2007-10-02,207160,207160,0,1,0.0,-17725.0
2007-10-03,207160,208691,1531,0,0.0,-17725.0
2007-10-04,208691,215324,6633,1,6633.0,-11092.0
2007-10-05,215324,215324,0,1,0.0,-11092.0
2007-10-06,215324,215324,0,1,0.0,-11092.0
2007-10-07,215324,221447,6123,1,6123.0,-4969.0
2007-10-08,221447,222977,1530,-1,-1530.0,-6499.0
2007-10-09,222977,220936,-2041,-1,2041.0,-4458.0
2007-10-10,220936,230121,9185,0,0.0,-4458.0
2007-10-11,230121,238795,8674,1,8674.0,4216.0
2007-10-12,238795,238795,0,1,0.0,4216.0
2007-10-13,238795,238795,0,-1,-0.0,4216.0
2007-10-14,238795,238285,-510,1,-510.0,3706.0
2007-10-15,238285,238795,510,0,0.0,3706.0
2007-10-16,238795,242367,3572,0,0.0,3706.0
2007-10-17,242367,238285,-4082,-1,4082.0,7788.0
2007-10-18,238285,248490,10205,-1,-10205.0,-2417.0
2007-10-19,248490,248490,0,0,0.0,-2417.0
2007-10-20,248490,248490,0,0,0.0,-2417.0
2007-10-21,248490,240836,-7654,1,-7654.0,-10071.0
2007-10-22,240836,265328,24492,1,24492.0,14421.0
2007-10-23,265328,258184,-7144,1,-7144.0,7277.0
2007-10-24,258184,270430,12246,-1,-12246.0,-4969.0
2007-10-25,270430,270430,0,1,0.0,-4969.0
2007-10-26,270430,270430,0,1,0.0,-4969.0
2007-10-27,270430,270430,0,1,0.0,-4969.0
2007-10-28,270430,275533,5103,1,5103.0,134.0
2007-10-29,275533,275533,0,-1,-0.0,134.0
2007-10-30,275533,267369,-8164,0,-0.0,134.0
2007-10-31,267369,294412,27043,-1,-27043.0,-26909.0
2007-11-01,294412,296963,2551,1,2551.0,-24358.0
2007-11-02,296963,296963,0,0,0.0,-24358.0
2007-11-03,296963,296963,0,-1,-0.0,-24358.0
2007-11-04,296963,291350,-5613,-1,5613.0,-18745.0
2007-11-05,291350,301045,9695,-1,-9695.0,-28440.0
2007-11-06,301045,289820,-11225,-1,11225.0,-17215.0
2007-11-07,289820,285738,-4082,0,-0.0,-17215.0
2007-11-08,285738,279615,-6123,-1,6123.0,-11092.0
2007-11-09,279615,279615,0,1,0.0,-11092.0
2007-11-10,279615,279615,0,0,0.0,-11092.0
2007-11-11,279615,252572,-27043,0,-0.0,-11092.0
2007-11-12,252572,240836,-11736,-1,11736.0,644.0
2007-11-13,240836,237775,-3061,1,-3061.0,-2417.0
2007-11-14,237775,219406,-18369,1,-18369.0,-20786.0
2007-11-15,219406,228080,8674,-1,-8674.0,-29460.0
2007-11-16,228080,228080,0,0,0.0,-29460.0
2007-11-17,228080,228080,0,0,0.0,-29460.0
2007-11-18,228080,216344,-11736,1,-11736.0,-41196.0
2007-11-19,216344,213283,-3061,1,-3061.0,-44257.0
2007-11-20,213283,200016,-13267,1,-13267.0,-57524.0
2007-11-21,200016,193383,-6633,1,-6633.0,-64157.0
2007-11-22,193383,172973,-20410,-1,20410.0,-43747.0
2007-11-23,172973,172973,0,-1,-0.0,-43747.0
2007-11-24,172973,172973,0,1,0.0,-43747.0
2007-11-25,172973,198486,25513,0,0.0,-43747.0
2007-11-26,198486,212262,13776,-1,-13776.0,-57523.0
2007-11-27,212262,209711,-2551,1,-2551.0,-60074.0
2007-11-28,209711,217875,8164,-1,-8164.0,-68238.0
2007-11-29,217875,231141,13266,-1,-13266.0,-81504.0
2007-11-30,231141,231141,0,-1,-0.0,-81504.0
2007-12-01,231141,231141,0,0,0.0,-81504.0
2007-12-02,231141,229100,-2041,1,-2041.0,-83545.0
2007-12-03,229100,229611,511,0,0.0,-83545.0
2007-12-04,229611,233182,3571,0,0.0,-83545.0
2007-12-05,233182,232162,-1020,1,-1020.0,-84565.0
2007-12-06,232162,219406,-12756,0,-0.0,-84565.0
2007-12-07,219406,219406,0,0,0.0,-84565.0
2007-12-08,219406,219406,0,1,0.0,-84565.0
2007-12-09,219406,206650,-12756,0,-0.0,-84565.0
2007-12-10,206650,202057,-4593,0,-0.0,-84565.0
2007-12-11,202057,196445,-5612,1,-5612.0,-90177.0
2007-12-12,196445,192873,-3572,0,-0.0,-90177.0
2007-12-13,192873,191342,-1531,-1,1531.0,-88646.0
2007-12-14,191342,191342,0,0,0.0,-88646.0
2007-12-15,191342,191342,0,-1,-0.0,-88646.0
2007-12-16,191342,183689,-7653,1,-7653.0,-96299.0
2007-12-17,183689,191852,8163,-1,-8163.0,-104462.0
2007-12-18,191852,191852,0,-1,-0.0,-104462.0
2007-12-19,191852,182668,-9184,1,-9184.0,-113646.0
2007-12-20,182668,182158,-510,0,-0.0,-113646.0
2007-12-21,182158,182158,0,-1,-0.0,-113646.0
2007-12-22,182158,182158,0,1,0.0,-113646.0
2007-12-23,182158,189811,7653,1,7653.0,-105993.0
2007-12-24,189811,189811,0,0,0.0,-105993.0
2007-12-25,189811,193893,4082,1,4082.0,-101911.0
2007-12-26,193893,197465,3572,1,3572.0,-98339.0
2007-12-27,197465,185219,-12246,-1,12246.0,-86093.0
2007-12-28,185219,185219,0,1,0.0,-86093.0
2007-12-29,185219,185219,0,0,0.0,-86093.0
2007-12-30,185219,185219,0,0,0.0,-86093.0
2007-12-31,185219,185219,0,1,0.0,-86093.0
2008-01-01,185219,178586,-6633,1,-6633.0,-92726.0
2008-01-02,178586,186240,7654,1,7654.0,-85072.0
2008-01-03,186240,195934,9694,1,9694.0,-75378.0
2008-01-04,195934,195934,0,-1,-0.0,-75378.0
2008-01-05,195934,195934,0,-1,-0.0,-75378.0
2008-01-06,195934,198486,2552,0,0.0,-75378.0
2008-01-07,198486,198996,510,0,0.0,-75378.0
2008-01-08,198996,210732,11736,0,0.0,-75378.0
2008-01-09,210732,207670,-3062,1,-3062.0,-78440.0
2008-01-10,207670,200016,-7654,0,-0.0,-78440.0
2008-01-11,200016,200016,0,0,0.0,-78440.0
2008-01-12,200016,200016,0,0,0.0,-78440.0
2008-01-13,200016,197975,-2041,0,-0.0,-78440.0
2008-01-14,197975,189301,-8674,1,-8674.0,-87114.0
2008-01-15,189301,189301,0,1,0.0,-87114.0
2008-01-16,189301,179096,-10205,0,-0.0,-87114.0
2008-01-17,179096,176545,-2551,-1,2551.0,-84563.0
2008-01-18,176545,176545,0,-1,-0.0,-84563.0
2008-01-19,176545,176545,0,1,0.0,-84563.0
2008-01-20,176545,162768,-13777,-1,13777.0,-70786.0
2008-01-21,162768,147971,-14797,1,-14797.0,-85583.0
2008-01-22,147971,145420,-2551,1,-2551.0,-88134.0
2008-01-23,145420,151543,6123,1,6123.0,-82011.0
2008-01-24,151543,166850,15307,-1,-15307.0,-97318.0
2008-01-25,166850,166850,0,1,0.0,-97318.0
2008-01-26,166850,166850,0,1,0.0,-97318.0
2008-01-27,166850,160217,-6633,1,-6633.0,-103951.0
2008-01-28,160217,153584,-6633,1,-6633.0,-110584.0
2008-01-29,153584,130623,-22961,1,-22961.0,-133545.0
2008-01-30,130623,131643,1020,0,0.0,-133545.0
2008-01-31,131643,136236,4593,-1,-4593.0,-138138.0
2008-02-01,136236,136236,0,-1,-0.0,-138138.0
2008-02-02,136236,136236,0,1,0.0,-138138.0
2008-02-03,136236,151033,14797,-1,-14797.0,-152935.0
2008-02-04,151033,161238,10205,0,0.0,-152935.0
2008-02-05,161238,161238,0,-1,-0.0,-152935.0
2008-02-06,161238,161238,0,-1,-0.0,-152935.0
2008-02-07,161238,161238,0,0,0.0,-152935.0
2008-02-08,161238,161238,0,-1,-0.0,-152935.0
2008-02-09,161238,161238,0,-1,-0.0,-152935.0
2008-02-10,161238,154094,-7144,-1,7144.0,-145791.0
2008-02-11,154094,155115,1021,-1,-1021.0,-146812.0
2008-02-12,155115,161238,6123,-1,-6123.0,-152935.0
2008-02-13,161238,183689,22451,1,22451.0,-130484.0
2008-02-14,183689,184709,1020,0,0.0,-130484.0
2008-02-15,184709,184709,0,0,0.0,-130484.0
2008-02-16,184709,184709,0,1,0.0,-130484.0
2008-02-17,184709,184709,0,1,0.0,-130484.0
2008-02-18,184709,184709,0,1,0.0,-130484.0
2008-02-19,184709,178586,-6123,-1,6123.0,-124361.0
2008-02-20,178586,182158,3572,-1,-3572.0,-127933.0
2008-02-21,182158,177566,-4592,0,-0.0,-127933.0
2008-02-22,177566,177566,0,0,0.0,-127933.0
2008-02-23,177566,177566,0,0,0.0,-127933.0
2008-02-24,177566,177055,-511,1,-511.0,-128444.0
2008-02-25,177055,177055,0,1,0.0,-128444.0
2008-02-26,177055,185730,8675,-1,-8675.0,-137119.0
2008-02-27,185730,188791,3061,-1,-3061.0,-140180.0
2008-02-28,188791,188281,-510,1,-510.0,-140690.0
2008-02-29,188281,188281,0,1,0.0,-140690.0
2008-03-01,188281,188281,0,1,0.0,-140690.0
2008-03-02,188281,181137,-7144,1,-7144.0,-147834.0
2008-03-03,181137,178586,-2551,-1,2551.0,-145283.0
2008-03-04,178586,180117,1531,1,1531.0,-143752.0
2008-03-05,180117,183689,3572,1,3572.0,-140180.0
2008-03-06,183689,179096,-4593,-1,4593.0,-135587.0
2008-03-07,179096,179096,0,1,0.0,-135587.0
2008-03-08,179096,179096,0,0,0.0,-135587.0
2008-03-09,179096,171443,-7653,0,-0.0,-135587.0
2008-03-10,171443,172463,1020,1,1020.0,-134567.0
2008-03-11,172463,174504,2041,-1,-2041.0,-136608.0
2008-03-12,174504,169402,-5102,-1,5102.0,-131506.0
2008-03-13,169402,171953,2551,-1,-2551.0,-134057.0
2008-03-14,171953,171953,0,-1,-0.0,-134057.0
2008-03-15,171953,171953,0,0,0.0,-134057.0
2008-03-16,171953,165830,-6123,1,-6123.0,-140180.0
2008-03-17,165830,165320,-510,0,-0.0,-140180.0
2008-03-18,165320,166850,1530,1,1530.0,-138650.0
2008-03-19,166850,161748,-5102,-1,5102.0,-133548.0
2008-03-20,161748,163789,2041,-1,-2041.0,-135589.0
2008-03-21,163789,163789,0,1,0.0,-135589.0
2008-03-22,163789,163789,0,-1,-0.0,-135589.0
2008-03-23,163789,163279,-510,1,-510.0,-136099.0
2008-03-24,163279,183178,19899,-1,-19899.0,-155998.0
2008-03-25,183178,184709,1531,-1,-1531.0,-157529.0
2008-03-26,184709,186240,1531,-1,-1531.0,-159060.0
2008-03-27,186240,195424,9184,1,9184.0,-149876.0
2008-03-28,195424,195424,0,0,0.0,-149876.0
2008-03-29,195424,195424,0,0,0.0,-149876.0
2008-03-30,195424,194914,-510,0,-0.0,-149876.0
2008-03-31,194914,185730,-9184,1,-9184.0,-159060.0
2008-04-01,185730,191852,6122,1,6122.0,-152938.0
2008-04-02,191852,191852,0,-1,-0.0,-152938.0
2008-04-03,191852,200527,8675,0,0.0,-152938.0
2008-04-04,200527,200527,0,1,0.0,-152938.0
2008-04-05,200527,200527,0,0,0.0,-152938.0
2008-04-06,200527,200016,-511,0,-0.0,-152938.0
2008-04-07,200016,194404,-5612,0,-0.0,-152938.0
2008-04-08,194404,194404,0,0,0.0,-152938.0
2008-04-09,194404,194914,510,-1,-510.0,-153448.0
2008-04-10,194914,186240,-8674,1,-8674.0,-162122.0
2008-04-11,186240,186240,0,-1,-0.0,-162122.0
2008-04-12,186240,186240,0,1,0.0,-162122.0
2008-04-13,186240,169912,-16328,0,-0.0,-162122.0
2008-04-14,169912,170932,1020,0,0.0,-162122.0
2008-04-15,170932,179607,8675,1,8675.0,-153447.0
2008-04-16,179607,177566,-2041,0,-0.0,-153447.0
2008-04-17,177566,175525,-2041,1,-2041.0,-155488.0
2008-04-18,175525,175525,0,-1,-0.0,-155488.0
2008-04-19,175525,175525,0,-1,-0.0,-155488.0
2008-04-20,175525,180117,4592,1,4592.0,-150896.0
2008-04-21,180117,179096,-1021,-1,1021.0,-149875.0
2008-04-22,179096,190322,11226,0,0.0,-149875.0
2008-04-23,190322,188791,-1531,0,-0.0,-149875.0
2008-04-24,188791,186750,-2041,1,-2041.0,-151916.0
2008-04-25,186750,186750,0,1,0.0,-151916.0
2008-04-26,186750,186750,0,1,0.0,-151916.0
2008-04-27,186750,177566,-9184,1,-9184.0,-161100.0
2008-04-28,177566,173994,-3572,1,-3572.0,-164672.0
2008-04-29,173994,176035,2041,0,0.0,-164672.0
2008-04-30,176035,176035,0,1,0.0,-164672.0
2008-05-01,176035,178586,2551,-1,-2551.0,-167223.0
2008-05-02,178586,178586,0,0,0.0,-167223.0
2008-05-03,178586,178586,0,0,0.0,-167223.0
2008-05-04,178586,178586,0,1,0.0,-167223.0
2008-05-05,178586,175525,-3061,0,-0.0,-167223.0
2008-05-06,175525,173484,-2041,1,-2041.0,-169264.0
2008-05-07,173484,178586,5102,-1,-5102.0,-174366.0
2008-05-08,178586,178586,0,0,0.0,-174366.0
2008-05-09,178586,178586,0,1,0.0,-174366.0
2008-05-10,178586,178586,0,0,0.0,-174366.0
2008-05-11,178586,178586,0,-1,-0.0,-174366.0
2008-05-12,178586,179607,1021,1,1021.0,-173345.0
2008-05-13,179607,172463,-7144,1,-7144.0,-180489.0
2008-05-14,172463,175525,3062,1,3062.0,-177427.0
2008-05-15,175525,177055,1530,0,0.0,-177427.0
2008-05-16,177055,177055,0,0,0.0,-177427.0
2008-05-17,177055,177055,0,-1,-0.0,-177427.0
2008-05-18,177055,180627,3572,-1,-3572.0,-180999.0
2008-05-19,180627,191342,10715,1,10715.0,-170284.0
2008-05-20,191342,197465,6123,0,0.0,-170284.0
2008-05-21,197465,194914,-2551,-1,2551.0,-167733.0
2008-05-22,194914,196955,2041,-1,-2041.0,-169774.0
2008-05-23,196955,196955,0,0,0.0,-169774.0
2008-05-24,196955,196955,0,0,0.0,-169774.0
2008-05-25,196955,200016,3061,1,3061.0,-166713.0
2008-05-26,200016,208691,8675,-1,-8675.0,-175388.0
2008-05-27,208691,205629,-3062,0,-0.0,-175388.0
2008-05-28,205629,204609,-1020,1,-1020.0,-176408.0
2008-05-29,204609,216344,11735,-1,-11735.0,-188143.0
2008-05-30,216344,216344,0,-1,-0.0,-188143.0
2008-05-31,216344,216344,0,1,0.0,-188143.0
2008-06-01,216344,215324,-1020,1,-1020.0,-189163.0
2008-06-02,215324,205119,-10205,0,-0.0,-189163.0
2008-06-03,205119,209711,4592,1,4592.0,-184571.0
2008-06-04,209711,216344,6633,0,0.0,-184571.0
2008-06-05,216344,216344,0,-1,-0.0,-184571.0
2008-06-06,216344,216344,0,1,0.0,-184571.0
2008-06-07,216344,216344,0,-1,-0.0,-184571.0
2008-06-08,216344,214303,-2041,1,-2041.0,-186612.0
2008-06-09,214303,206139,-8164,1,-8164.0,-194776.0
2008-06-10,206139,206650,511,1,511.0,-194265.0
2008-06-11,206650,196955,-9695,0,-0.0,-194265.0
2008-06-12,196955,200016,3061,0,0.0,-194265.0
2008-06-13,200016,200016,0,-1,-0.0,-194265.0
2008-06-14,200016,200016,0,0,0.0,-194265.0
2008-06-15,200016,194404,-5612,0,-0.0,-194265.0
2008-06-16,194404,188791,-5613,1,-5613.0,-199878.0
2008-06-17,188791,187770,-1021,0,-0.0,-199878.0
2008-06-18,187770,186750,-1020,1,-1020.0,-200898.0
2008-06-19,186750,186240,-510,0,-0.0,-200898.0
2008-06-20,186240,186240,0,1,0.0,-200898.0
2008-06-21,186240,186240,0,0,0.0,-200898.0
2008-06-22,186240,182668,-3572,1,-3572.0,-204470.0
2008-06-23,182668,186750,4082,1,4082.0,-200388.0
2008-06-24,186750,189811,3061,1,3061.0,-197327.0
2008-06-25,189811,189811,0,0,0.0,-197327.0
2008-06-26,189811,185219,-4592,0,-0.0,-197327.0
2008-06-27,185219,185219,0,1,0.0,-197327.0
2008-06-28,185219,185219,0,1,0.0,-197327.0
2008-06-29,185219,178586,-6633,-1,6633.0,-190694.0
2008-06-30,178586,170422,-8164,1,-8164.0,-198858.0
2008-07-01,170422,163789,-6633,1,-6633.0,-205491.0
2008-07-02,163789,150012,-13777,0,-0.0,-205491.0
2008-07-03,150012,141338,-8674,-1,8674.0,-196817.0
2008-07-04,141338,141338,0,1,0.0,-196817.0
2008-07-05,141338,141338,0,-1,-0.0,-196817.0
2008-07-06,141338,139807,-1531,1,-1531.0,-198348.0
2008-07-07,139807,138787,-1020,-1,1020.0,-197328.0
2008-07-08,138787,136746,-2041,0,-0.0,-197328.0
2008-07-09,136746,142359,5613,1,5613.0,-191715.0
2008-07-10,142359,148482,6123,1,6123.0,-185592.0
2008-07-11,148482,148482,0,0,0.0,-185592.0
2008-07-12,148482,148482,0,0,0.0,-185592.0
2008-07-13,148482,146441,-2041,1,-2041.0,-187633.0
2008-07-14,146441,142869,-3572,1,-3572.0,-191205.0
2008-07-15,142869,141848,-1021,0,-0.0,-191205.0
2008-07-16,141848,146441,4593,0,0.0,-191205.0
2008-07-17,146441,143889,-2552,0,-0.0,-191205.0
2008-07-18,143889,143889,0,0,0.0,-191205.0
2008-07-19,143889,143889,0,0,0.0,-191205.0
2008-07-20,143889,147971,4082,1,4082.0,-187123.0
2008-07-21,147971,148482,511,1,511.0,-186612.0
2008-07-22,148482,154605,6123,-1,-6123.0,-192735.0
2008-07-23,154605,157666,3061,0,0.0,-192735.0
2008-07-24,157666,156135,-1531,1,-1531.0,-194266.0
2008-07-25,156135,156135,0,-1,-0.0,-194266.0
2008-07-26,156135,156135,0,0,0.0,-194266.0
2008-07-27,156135,159197,3062,0,0.0,-194266.0
2008-07-28,159197,163279,4082,0,0.0,-194266.0
2008-07-29,163279,170422,7143,-1,-7143.0,-201409.0
2008-07-30,170422,170422,0,-1,-0.0,-201409.0
2008-07-31,170422,164299,-6123,0,-0.0,-201409.0
2008-08-01,164299,164299,0,1,0.0,-201409.0
2008-08-02,164299,164299,0,0,0.0,-201409.0
2008-08-03,164299,157156,-7143,1,-7143.0,-208552.0
2008-08-04,157156,158176,1020,1,1020.0,-207532.0
2008-08-05,158176,161748,3572,-1,-3572.0,-211104.0
2008-08-06,161748,160217,-1531,1,-1531.0,-212635.0
2008-08-07,160217,163789,3572,-1,-3572.0,-216207.0
2008-08-08,163789,163789,0,-1,-0.0,-216207.0
2008-08-09,163789,163789,0,-1,-0.0,-216207.0
2008-08-10,163789,164809,1020,0,0.0,-216207.0
2008-08-11,164809,160217,-4592,-1,4592.0,-211615.0
2008-08-12,160217,155115,-5102,1,-5102.0,-216717.0
2008-08-13,155115,158176,3061,1,3061.0,-213656.0
2008-08-14,158176,158176,0,1,0.0,-213656.0
2008-08-15,158176,158176,0,0,0.0,-213656.0
2008-08-16,158176,158176,0,0,0.0,-213656.0
2008-08-17,158176,160727,2551,0,0.0,-213656.0
2008-08-18,160727,159707,-1020,1,-1020.0,-214676.0
2008-08-19,159707,158686,-1021,-1,1021.0,-213655.0
2008-08-20,158686,153584,-5102,-1,5102.0,-208553.0
2008-08-21,153584,147461,-6123,1,-6123.0,-214676.0
2008-08-22,147461,147461,0,-1,-0.0,-214676.0
2008-08-23,147461,147461,0,0,0.0,-214676.0
2008-08-24,147461,145930,-1531,1,-1531.0,-216207.0
2008-08-25,145930,145930,0,-1,-0.0,-216207.0
2008-08-26,145930,149502,3572,-1,-3572.0,-219779.0
2008-08-27,149502,147971,-1531,1,-1531.0,-221310.0
2008-08-28,147971,126031,-21940,1,-21940.0,-243250.0
2008-08-29,126031,126031,0,-1,-0.0,-243250.0
2008-08-30,126031,126031,0,-1,-0.0,-243250.0
2008-08-31,126031,107152,-18879,1,-18879.0,-262129.0
2008-09-01,107152,106131,-1021,1,-1021.0,-263150.0
2008-09-02,106131,110213,4082,1,4082.0,-259068.0
2008-09-03,110213,111234,1021,0,0.0,-259068.0
2008-09-04,111234,109193,-2041,-1,2041.0,-257027.0
2008-09-05,109193,109193,0,0,0.0,-257027.0
2008-09-06,109193,109193,0,-1,-0.0,-257027.0
2008-09-07,109193,121439,12246,0,0.0,-257027.0
2008-09-08,121439,114295,-7144,1,-7144.0,-264171.0
2008-09-09,114295,114295,0,0,0.0,-264171.0
2008-09-10,114295,114295,0,1,0.0,-264171.0
2008-09-11,114295,115316,1021,0,0.0,-264171.0
2008-09-12,115316,115316,0,0,0.0,-264171.0
2008-09-13,115316,115316,0,-1,-0.0,-264171.0
2008-09-14,115316,115316,0,1,0.0,-264171.0
2008-09-15,115316,107152,-8164,1,-8164.0,-272335.0
2008-09-16,107152,111744,4592,1,4592.0,-267743.0
2008-09-17,111744,106641,-5103,1,-5103.0,-272846.0
2008-09-18,106641,110213,3572,1,3572.0,-269274.0
2008-09-19,110213,110213,0,0,0.0,-269274.0
2008-09-20,110213,110213,0,0,0.0,-269274.0
2008-09-21,110213,114295,4082,-1,-4082.0,-273356.0
2008-09-22,114295,119398,5103,1,5103.0,-268253.0
2008-09-23,119398,129092,9694,-1,-9694.0,-277947.0
2008-09-24,129092,132154,3062,1,3062.0,-274885.0
2008-09-25,132154,127051,-5103,1,-5103.0,-279988.0
2008-09-26,127051,127051,0,-1,-0.0,-279988.0
2008-09-27,127051,127051,0,1,0.0,-279988.0
2008-09-28,127051,123990,-3061,-1,3061.0,-276927.0
2008-09-29,123990,119398,-4592,-1,4592.0,-272335.0
2008-09-30,119398,115826,-3572,-1,3572.0,-268763.0
2008-10-01,115826,109703,-6123,-1,6123.0,-262640.0
2008-10-02,109703,109703,0,1,0.0,-262640.0
2008-10-03,109703,109703,0,0,0.0,-262640.0
2008-10-04,109703,109703,0,-1,-0.0,-262640.0
2008-10-05,109703,96845,-12858,1,-12858.0,-275498.0
2008-10-06,96845,95416,-1429,1,-1429.0,-276927.0
2008-10-07,95416,81129,-14287,1,-14287.0,-291214.0
2008-10-08,81129,86027,4898,-1,-4898.0,-296112.0
2008-10-09,86027,80517,-5510,-1,5510.0,-290602.0
2008-10-10,80517,80517,0,-1,-0.0,-290602.0
2008-10-11,80517,80517,0,1,0.0,-290602.0
2008-10-12,80517,90824,10307,0,0.0,-290602.0
2008-10-13,90824,102049,11225,-1,-11225.0,-301827.0
2008-10-14,102049,102049,0,0,0.0,-301827.0
2008-10-15,102049,91232,-10817,-1,10817.0,-291010.0
2008-10-16,91232,92967,1735,-1,-1735.0,-292745.0
2008-10-17,92967,92967,0,-1,-0.0,-292745.0
2008-10-18,92967,92967,0,1,0.0,-292745.0
2008-10-19,92967,87762,-5205,-1,5205.0,-287540.0
2008-10-20,87762,87660,-102,1,-102.0,-287642.0
2008-10-21,87660,87558,-102,-1,102.0,-287540.0
2008-10-22,87558,83068,-4490,-1,4490.0,-283050.0
2008-10-23,83068,70618,-12450,0,-0.0,-283050.0
2008-10-24,70618,70618,0,0,0.0,-283050.0
2008-10-25,70618,70618,0,-1,-0.0,-283050.0
2008-10-26,70618,70720,102,0,0.0,-283050.0
2008-10-27,70720,77966,7246,-1,-7246.0,-290296.0
2008-10-28,77966,76027,-1939,0,-0.0,-290296.0
2008-10-29,76027,87354,11327,1,11327.0,-278969.0
2008-10-30,87354,93375,6021,-1,-6021.0,-284990.0
2008-10-31,93375,93375,0,1,0.0,-284990.0
2008-11-01,93375,93375,0,-1,-0.0,-284990.0
2008-11-02,93375,98477,5102,1,5102.0,-279888.0
2008-11-03,98477,99396,919,-1,-919.0,-280807.0
2008-11-04,99396,100008,612,1,612.0,-280195.0
2008-11-05,100008,85721,-14287,0,-0.0,-280195.0
2008-11-06,85721,85313,-408,-1,408.0,-279787.0
2008-11-07,85313,85313,0,-1,-0.0,-279787.0
2008-11-08,85313,85313,0,1,0.0,-279787.0
2008-11-09,85313,97559,12246,1,12246.0,-267541.0
2008-11-10,97559,92865,-4694,-1,4694.0,-262847.0
2008-11-11,92865,90416,-2449,1,-2449.0,-265296.0
2008-11-12,90416,87558,-2858,1,-2858.0,-268154.0
2008-11-13,87558,84599,-2959,1,-2959.0,-271113.0
2008-11-14,84599,84599,0,0,0.0,-271113.0
2008-11-15,84599,84599,0,1,0.0,-271113.0
2008-11-16,84599,80619,-3980,0,-0.0,-271113.0
2008-11-17,80619,76945,-3674,-1,3674.0,-267439.0
2008-11-18,76945,74394,-2551,0,-0.0,-267439.0
2008-11-19,74394,63270,-11124,1,-11124.0,-278563.0
2008-11-20,63270,69087,5817,0,0.0,-278563.0
2008-11-21,69087,69087,0,0,0.0,-278563.0
2008-11-22,69087,69087,0,1,0.0,-278563.0
2008-11-23,69087,62454,-6633,0,-0.0,-278563.0
2008-11-24,62454,58576,-3878,0,-0.0,-278563.0
2008-11-25,58576,60719,2143,1,2143.0,-276420.0
2008-11-26,60719,69802,9083,0,0.0,-276420.0
2008-11-27,69802,72353,2551,-1,-2551.0,-278971.0
2008-11-28,72353,72353,0,0,0.0,-278971.0
2008-11-29,72353,72353,0,0,0.0,-278971.0
2008-11-30,72353,75618,3265,-1,-3265.0,-282236.0
2008-12-01,75618,75006,-612,0,-0.0,-282236.0
2008-12-02,75006,83986,8980,-1,-8980.0,-291216.0
2008-12-03,83986,85619,1633,-1,-1633.0,-292849.0
2008-12-04,85619,83680,-1939,0,-0.0,-292849.0
2008-12-05,83680,83680,0,0,0.0,-292849.0
2008-12-06,83680,83680,0,1,0.0,-292849.0
2008-12-07,83680,95926,12246,-1,-12246.0,-305095.0
2008-12-08,95926,93783,-2143,0,-0.0,-305095.0
2008-12-09,93783,93375,-408,1,-408.0,-305503.0
2008-12-10,93375,95824,2449,1,2449.0,-303054.0
2008-12-11,95824,92355,-3469,0,-0.0,-303054.0
2008-12-12,92355,92355,0,1,0.0,-303054.0
2008-12-13,92355,92355,0,0,0.0,-303054.0
2008-12-14,92355,97967,5612,0,0.0,-303054.0
2008-12-15,97967,99090,1123,0,0.0,-303054.0
2008-12-16,99090,96539,-2551,-1,2551.0,-300503.0
2008-12-17,96539,95416,-1123,1,-1123.0,-301626.0
2008-12-18,95416,93885,-1531,-1,1531.0,-300095.0
2008-12-19,93885,93885,0,1,0.0,-300095.0
2008-12-20,93885,93885,0,0,0.0,-300095.0
2008-12-21,93885,91640,-2245,-1,2245.0,-297850.0
2008-12-22,91640,90518,-1122,1,-1122.0,-298972.0
2008-12-23,90518,90824,306,-1,-306.0,-299278.0
2008-12-24,90824,90824,0,0,0.0,-299278.0
2008-12-25,90824,92252,1428,1,1428.0,-297850.0
2008-12-26,92252,92252,0,0,0.0,-297850.0
2008-12-27,92252,92252,0,1,0.0,-297850.0
2008-12-28,92252,95314,3062,0,0.0,-297850.0
2008-12-29,95314,98477,3163,1,3163.0,-294687.0
2008-12-30,98477,98477,0,1,0.0,-294687.0
2008-12-31,98477,98477,0,0,0.0,-294687.0
2009-01-01,98477,96539,-1938,0,-0.0,-294687.0
2009-01-02,96539,96539,0,-1,-0.0,-294687.0
2009-01-03,96539,96539,0,-1,-0.0,-294687.0
2009-01-04,96539,93375,-3164,0,-0.0,-294687.0
2009-01-05,93375,93273,-102,0,-0.0,-294687.0
2009-01-06,93273,104600,11327,1,11327.0,-283360.0
2009-01-07,104600,104600,0,1,0.0,-283360.0
2009-01-08,104600,107152,2552,0,0.0,-283360.0
2009-01-09,107152,107152,0,0,0.0,-283360.0
2009-01-10,107152,107152,0,1,0.0,-283360.0
2009-01-11,107152,101641,-5511,1,-5511.0,-288871.0
2009-01-12,101641,99804,-1837,1,-1837.0,-290708.0
2009-01-13,99804,104600,4796,1,4796.0,-285912.0
2009-01-14,104600,101029,-3571,0,-0.0,-285912.0
2009-01-15,101029,107152,6123,0,0.0,-285912.0
2009-01-16,107152,107152,0,1,0.0,-285912.0
2009-01-17,107152,107152,0,1,0.0,-285912.0
2009-01-18,107152,104090,-3062,1,-3062.0,-288974.0
2009-01-19,104090,105621,1531,1,1531.0,-287443.0
2009-01-20,105621,102559,-3062,1,-3062.0,-290505.0
2009-01-21,102559,104600,2041,1,2041.0,-288464.0
2009-01-22,104600,104600,0,-1,-0.0,-288464.0
2009-01-23,104600,104600,0,1,0.0,-288464.0
2009-01-24,104600,104600,0,-1,-0.0,-288464.0
2009-01-25,104600,104600,0,1,0.0,-288464.0
2009-01-26,104600,104600,0,1,0.0,-288464.0
2009-01-27,104600,107152,2552,1,2552.0,-285912.0
2009-01-28,107152,110723,3571,-1,-3571.0,-289483.0
2009-01-29,110723,108172,-2551,1,-2551.0,-292034.0
2009-01-30,108172,108172,0,0,0.0,-292034.0
2009-01-31,108172,108172,0,1,0.0,-292034.0
2009-02-01,108172,105111,-3061,-1,3061.0,-288973.0
2009-02-02,105111,106641,1530,-1,-1530.0,-290503.0
2009-02-03,106641,109703,3062,1,3062.0,-287441.0
2009-02-04,109703,108682,-1021,0,-0.0,-287441.0
2009-02-05,108682,113275,4593,-1,-4593.0,-292034.0
2009-02-06,113275,113275,0,1,0.0,-292034.0
2009-02-07,113275,113275,0,0,0.0,-292034.0
2009-02-08,113275,113785,510,0,0.0,-292034.0
2009-02-09,113785,115316,1531,0,0.0,-292034.0
2009-02-10,115316,114805,-511,-1,511.0,-291523.0
2009-02-11,114805,119398,4593,-1,-4593.0,-296116.0
2009-02-12,119398,116336,-3062,-1,3062.0,-293054.0
2009-02-13,116336,116336,0,0,0.0,-293054.0
2009-02-14,116336,116336,0,-1,-0.0,-293054.0
2009-02-15,116336,119908,3572,0,0.0,-293054.0
2009-02-16,119908,113785,-6123,-1,6123.0,-286931.0
2009-02-17,113785,115826,2041,1,2041.0,-284890.0
2009-02-18,115826,114805,-1021,0,-0.0,-284890.0
2009-02-19,114805,110213,-4592,-1,4592.0,-280298.0
2009-02-20,110213,110213,0,-1,-0.0,-280298.0
2009-02-21,110213,110213,0,0,0.0,-280298.0
2009-02-22,110213,109703,-510,-1,510.0,-279788.0
2009-02-23,109703,104600,-5103,0,-0.0,-279788.0
2009-02-24,104600,105111,511,-1,-511.0,-280299.0
2009-02-25,105111,98477,-6634,0,-0.0,-280299.0
2009-02-26,98477,100927,2450,1,2450.0,-277849.0
2009-02-27,100927,100927,0,1,0.0,-277849.0
2009-02-28,100927,100927,0,1,0.0,-277849.0
2009-03-01,100927,93273,-7654,-1,7654.0,-270195.0
2009-03-02,93273,87354,-5919,0,-0.0,-270195.0
2009-03-03,87354,90824,3470,-1,-3470.0,-273665.0
2009-03-04,90824,87864,-2960,0,-0.0,-273665.0
2009-03-05,87864,91640,3776,-1,-3776.0,-277441.0
2009-03-06,91640,91640,0,1,0.0,-277441.0
2009-03-07,91640,91640,0,1,0.0,-277441.0
2009-03-08,91640,89293,-2347,-1,2347.0,-275094.0
2009-03-09,89293,93783,4490,0,0.0,-275094.0
2009-03-10,93783,94395,612,1,612.0,-274482.0
2009-03-11,94395,91844,-2551,-1,2551.0,-271931.0
2009-03-12,91844,93069,1225,-1,-1225.0,-273156.0
2009-03-13,93069,93069,0,-1,-0.0,-273156.0
2009-03-14,93069,93069,0,-1,-0.0,-273156.0
2009-03-15,93069,91130,-1939,-1,1939.0,-271217.0
2009-03-16,91130,92661,1531,-1,-1531.0,-272748.0
2009-03-17,92661,90824,-1837,1,-1837.0,-274585.0
2009-03-18,90824,88170,-2654,-1,2654.0,-271931.0
2009-03-19,88170,89293,1123,1,1123.0,-270808.0
2009-03-20,89293,89293,0,1,0.0,-270808.0
2009-03-21,89293,89293,0,0,0.0,-270808.0
2009-03-22,89293,93069,3776,1,3776.0,-267032.0
2009-03-23,93069,106641,13572,-1,-13572.0,-280604.0
2009-03-24,106641,109703,3062,-1,-3062.0,-283666.0
2009-03-25,109703,108682,-1021,1,-1021.0,-284687.0
2009-03-26,108682,108682,0,-1,-0.0,-284687.0
2009-03-27,108682,108682,0,0,0.0,-284687.0
2009-03-28,108682,108682,0,-1,-0.0,-284687.0
2009-03-29,108682,101029,-7653,-1,7653.0,-277034.0
2009-03-30,101029,102049,1020,1,1020.0,-276014.0
2009-03-31,102049,107152,5103,0,0.0,-276014.0
2009-04-01,107152,113785,6633,1,6633.0,-269381.0
2009-04-02,113785,122459,8674,1,8674.0,-260707.0
2009-04-03,122459,122459,0,-1,-0.0,-260707.0
2009-04-04,122459,122459,0,1,0.0,-260707.0
2009-04-05,122459,120928,-1531,-1,1531.0,-259176.0
2009-04-06,120928,117867,-3061,0,-0.0,-259176.0
2009-04-07,117867,115316,-2551,0,-0.0,-259176.0
2009-04-08,115316,125010,9694,0,0.0,-259176.0
2009-04-09,125010,129602,4592,1,4592.0,-254584.0
2009-04-10,129602,129602,0,-1,-0.0,-254584.0
2009-04-11,129602,129602,0,0,0.0,-254584.0
2009-04-12,129602,132664,3062,1,3062.0,-251522.0
2009-04-13,132664,132154,-510,1,-510.0,-252032.0
2009-04-14,132154,128582,-3572,1,-3572.0,-255604.0
2009-04-15,128582,132154,3572,0,0.0,-255604.0
2009-04-16,132154,123990,-8164,-1,8164.0,-247440.0
2009-04-17,123990,123990,0,1,0.0,-247440.0
2009-04-18,123990,123990,0,1,0.0,-247440.0
2009-04-19,123990,123990,0,-1,-0.0,-247440.0
2009-04-20,123990,123990,0,-1,-0.0,-247440.0
2009-04-21,123990,125520,1530,0,0.0,-247440.0
2009-04-22,125520,122459,-3061,1,-3061.0,-250501.0
2009-04-23,122459,127051,4592,-1,-4592.0,-255093.0
2009-04-24,127051,127051,0,1,0.0,-255093.0
2009-04-25,127051,127051,0,0,0.0,-255093.0
2009-04-26,127051,124500,-2551,0,-0.0,-255093.0
2009-04-27,124500,116846,-7654,1,-7654.0,-262747.0
2009-04-28,116846,122459,5613,1,5613.0,-257134.0
2009-04-29,122459,130623,8164,0,0.0,-257134.0
2009-04-30,130623,130623,0,-1,-0.0,-257134.0
2009-05-01,130623,130623,0,-1,-0.0,-257134.0
2009-05-02,130623,130623,0,-1,-0.0,-257134.0
2009-05-03,130623,135725,5102,1,5102.0,-252032.0
2009-05-04,135725,135725,0,1,0.0,-252032.0
2009-05-05,135725,134195,-1530,1,-1530.0,-253562.0
2009-05-06,134195,136746,2551,1,2551.0,-251011.0
2009-05-07,136746,132664,-4082,1,-4082.0,-255093.0
2009-05-08,132664,132664,0,0,0.0,-255093.0
2009-05-09,132664,132664,0,0,0.0,-255093.0
2009-05-10,132664,133174,510,0,0.0,-255093.0
2009-05-11,133174,129092,-4082,-1,4082.0,-251011.0
2009-05-12,129092,121949,-7143,-1,7143.0,-243868.0
2009-05-13,121949,116846,-5103,-1,5103.0,-238765.0
2009-05-14,116846,117357,511,1,511.0,-238254.0
2009-05-15,117357,117357,0,0,0.0,-238254.0
2009-05-16,117357,117357,0,0,0.0,-238254.0
2009-05-17,117357,114295,-3062,0,-0.0,-238254.0
2009-05-18,114295,121439,7144,0,0.0,-238254.0
2009-05-19,121439,120418,-1021,-1,1021.0,-237233.0
2009-05-20,120418,115316,-5102,1,-5102.0,-242335.0
2009-05-21,115316,108682,-6634,1,-6634.0,-248969.0
2009-05-22,108682,108682,0,-1,-0.0,-248969.0
2009-05-23,108682,108682,0,-1,-0.0,-248969.0
2009-05-24,108682,112254,3572,0,0.0,-248969.0
2009-05-25,112254,108172,-4082,0,-0.0,-248969.0
2009-05-26,108172,105111,-3061,0,-0.0,-248969.0
2009-05-27,105111,107152,2041,0,0.0,-248969.0
2009-05-28,107152,111744,4592,1,4592.0,-244377.0
2009-05-29,111744,111744,0,1,0.0,-244377.0
2009-05-30,111744,111744,0,0,0.0,-244377.0
2009-05-31,111744,113275,1531,-1,-1531.0,-245908.0
2009-06-01,113275,122459,9184,-1,-9184.0,-255092.0
2009-06-02,122459,122459,0,-1,-0.0,-255092.0
2009-06-03,122459,116846,-5613,-1,5613.0,-249479.0
2009-06-04,116846,112764,-4082,1,-4082.0,-253561.0
2009-06-05,112764,112764,0,-1,-0.0,-253561.0
2009-06-06,112764,112764,0,-1,-0.0,-253561.0
2009-06-07,112764,107152,-5612,1,-5612.0,-259173.0
2009-06-08,107152,105111,-2041,0,-0.0,-259173.0
2009-06-09,105111,105621,510,0,0.0,-259173.0
2009-06-10,105621,109193,3572,0,0.0,-259173.0
2009-06-11,109193,106641,-2552,0,-0.0,-259173.0
2009-06-12,106641,106641,0,0,0.0,-259173.0
2009-06-13,106641,106641,0,1,0.0,-259173.0
2009-06-14,106641,106641,0,-1,-0.0,-259173.0
2009-06-15,106641,106131,-510,-1,510.0,-258663.0
2009-06-16,106131,106641,510,1,510.0,-258153.0
2009-06-17,106641,104090,-2551,0,-0.0,-258153.0
2009-06-18,104090,104600,510,1,510.0,-257643.0
2009-06-19,104600,104600,0,1,0.0,-257643.0
2009-06-20,104600,104600,0,-1,-0.0,-257643.0
2009-06-21,104600,105111,511,0,0.0,-257643.0
2009-06-22,105111,100416,-4695,-1,4695.0,-252948.0
2009-06-23,100416,97049,-3367,0,-0.0,-252948.0
2009-06-24,97049,97355,306,0,0.0,-252948.0
2009-06-25,97355,92967,-4388,1,-4388.0,-257336.0
2009-06-26,92967,92967,0,0,0.0,-257336.0
2009-06-27,92967,92967,0,-1,-0.0,-257336.0
2009-06-28,92967,87762,-5205,-1,5205.0,-252131.0
2009-06-29,87762,90824,3062,0,0.0,-252131.0
2009-06-30,90824,92355,1531,1,1531.0,-250600.0
2009-07-01,92355,92048,-307,1,-307.0,-250907.0
2009-07-02,92048,90824,-1224,-1,1224.0,-249683.0
2009-07-03,90824,90824,0,1,0.0,-249683.0
2009-07-04,90824,90824,0,-1,-0.0,-249683.0
2009-07-05,90824,89905,-919,-1,919.0,-248764.0
2009-07-06,89905,88783,-1122,0,-0.0,-248764.0
2009-07-07,88783,88579,-204,1,-204.0,-248968.0
2009-07-08,88579,89191,612,0,0.0,-248968.0
2009-07-09,89191,87354,-1837,0,-0.0,-248968.0
2009-07-10,87354,87354,0,-1,-0.0,-248968.0
2009-07-11,87354,87354,0,0,0.0,-248968.0
2009-07-12,87354,79598,-7756,1,-7756.0,-256724.0
2009-07-13,79598,78476,-1122,0,-0.0,-256724.0
2009-07-14,78476,80313,1837,1,1837.0,-254887.0
2009-07-15,80313,83476,3163,-1,-3163.0,-258050.0
2009-07-16,83476,82456,-1020,-1,1020.0,-257030.0
2009-07-17,82456,82456,0,1,0.0,-257030.0
2009-07-18,82456,82456,0,0,0.0,-257030.0
2009-07-19,82456,85721,3265,-1,-3265.0,-260295.0
2009-07-20,85721,89191,3470,0,0.0,-260295.0
2009-07-21,89191,88885,-306,1,-306.0,-260601.0
2009-07-22,88885,88987,102,-1,-102.0,-260703.0
2009-07-23,88987,90211,1224,1,1224.0,-259479.0
2009-07-24,90211,90211,0,1,0.0,-259479.0
2009-07-25,90211,90211,0,1,0.0,-259479.0
2009-07-26,90211,89905,-306,0,-0.0,-259479.0
2009-07-27,89905,90314,409,-1,-409.0,-259888.0
2009-07-28,90314,89599,-715,0,-0.0,-259888.0
2009-07-29,89599,90211,612,0,0.0,-259888.0
2009-07-30,90211,90824,613,0,0.0,-259888.0
2009-07-31,90824,90824,0,0,0.0,-259888.0
2009-08-01,90824,90824,0,1,0.0,-259888.0
2009-08-02,90824,95008,4184,-1,-4184.0,-264072.0
2009-08-03,95008,93273,-1735,1,-1735.0,-265807.0
2009-08-04,93273,91640,-1633,-1,1633.0,-264174.0
2009-08-05,91640,90926,-714,0,-0.0,-264174.0
2009-08-06,90926,94293,3367,1,3367.0,-260807.0
2009-08-07,94293,94293,0,-1,-0.0,-260807.0
2009-08-08,94293,94293,0,1,0.0,-260807.0
2009-08-09,94293,95008,715,1,715.0,-260092.0
2009-08-10,95008,97355,2347,1,2347.0,-257745.0
2009-08-11,97355,98171,816,-1,-816.0,-258561.0
2009-08-12,98171,97865,-306,1,-306.0,-258867.0
2009-08-13,97865,98886,1021,0,0.0,-258867.0
2009-08-14,98886,98886,0,0,0.0,-258867.0
2009-08-15,98886,98886,0,-1,-0.0,-258867.0
2009-08-16,98886,96232,-2654,1,-2654.0,-261521.0
2009-08-17,96232,96743,511,-1,-511.0,-262032.0
2009-08-18,96743,90722,-6021,1,-6021.0,-268053.0
2009-08-19,90722,89701,-1021,0,-0.0,-268053.0
2009-08-20,89701,83986,-5715,1,-5715.0,-273768.0
2009-08-21,83986,83986,0,-1,-0.0,-273768.0
2009-08-22,83986,83986,0,0,0.0,-273768.0
2009-08-23,83986,83986,0,1,0.0,-273768.0
2009-08-24,83986,83476,-510,1,-510.0,-274278.0
2009-08-25,83476,87558,4082,0,0.0,-274278.0
2009-08-26,87558,89803,2245,0,0.0,-274278.0
2009-08-27,89803,88170,-1633,-1,1633.0,-272645.0
2009-08-28,88170,88170,0,1,0.0,-272645.0
2009-08-29,88170,88170,0,1,0.0,-272645.0
2009-08-30,88170,85007,-3163,0,-0.0,-272645.0
2009-08-31,85007,85721,714,0,0.0,-272645.0
2009-09-01,85721,82864,-2857,0,-0.0,-272645.0
2009-09-02,82864,83374,510,0,0.0,-272645.0
2009-09-03,83374,85415,2041,0,0.0,-272645.0
2009-09-04,85415,85415,0,-1,-0.0,-272645.0
2009-09-05,85415,85415,0,0,0.0,-272645.0
2009-09-06,85415,85313,-102,1,-102.0,-272747.0
2009-09-07,85313,87660,2347,1,2347.0,-270400.0
2009-09-08,87660,89803,2143,-1,-2143.0,-272543.0
2009-09-09,89803,95926,6123,0,0.0,-272543.0
2009-09-10,95926,96130,204,-1,-204.0,-272747.0
2009-09-11,96130,96130,0,-1,-0.0,-272747.0
2009-09-12,96130,96130,0,0,0.0,-272747.0
2009-09-13,96130,94089,-2041,0,-0.0,-272747.0
2009-09-14,94089,90416,-3673,0,-0.0,-272747.0
2009-09-15,90416,93987,3571,0,0.0,-272747.0
2009-09-16,93987,98988,5001,1,5001.0,-267746.0
2009-09-17,98988,102559,3571,1,3571.0,-264175.0
2009-09-18,102559,102559,0,-1,-0.0,-264175.0
2009-09-19,102559,102559,0,1,0.0,-264175.0
2009-09-20,102559,101845,-714,0,-0.0,-264175.0
2009-09-21,101845,100620,-1225,-1,1225.0,-262950.0
2009-09-22,100620,96232,-4388,-1,4388.0,-258562.0
2009-09-23,96232,94600,-1632,0,-0.0,-258562.0
2009-09-24,94600,97967,3367,0,0.0,-258562.0
2009-09-25,97967,97967,0,-1,-0.0,-258562.0
2009-09-26,97967,97967,0,0,0.0,-258562.0
2009-09-27,97967,98682,715,0,0.0,-258562.0
2009-09-28,98682,96130,-2552,0,-0.0,-258562.0
2009-09-29,96130,90824,-5306,0,-0.0,-258562.0
2009-09-30,90824,89089,-1735,1,-1735.0,-260297.0
2009-10-01,89089,89089,0,0,0.0,-260297.0
2009-10-02,89089,89089,0,-1,-0.0,-260297.0
2009-10-03,89089,89089,0,0,0.0,-260297.0
2009-10-04,89089,87252,-1837,1,-1837.0,-262134.0
2009-10-05,87252,89701,2449,-1,-2449.0,-264583.0
2009-10-06,89701,89293,-408,0,-0.0,-264583.0
2009-10-07,89293,90314,1021,0,0.0,-264583.0
2009-10-08,90314,93681,3367,-1,-3367.0,-267950.0
2009-10-09,93681,93681,0,1,0.0,-267950.0
2009-10-10,93681,93681,0,0,0.0,-267950.0
2009-10-11,93681,92967,-714,-1,714.0,-267236.0
2009-10-12,92967,90007,-2960,1,-2960.0,-270196.0
2009-10-13,90007,91640,1633,0,0.0,-270196.0
2009-10-14,91640,96334,4694,1,4694.0,-265502.0
2009-10-15,96334,95212,-1122,0,-0.0,-265502.0
2009-10-16,95212,95212,0,-1,-0.0,-265502.0
2009-10-17,95212,95212,0,-1,-0.0,-265502.0
2009-10-18,95212,95824,612,0,0.0,-265502.0
2009-10-19,95824,98886,3062,0,0.0,-265502.0
2009-10-20,98886,99804,918,0,0.0,-265502.0
2009-10-21,99804,99498,-306,-1,306.0,-265196.0
2009-10-22,99498,91232,-8266,0,-0.0,-265196.0
2009-10-23,91232,91232,0,1,0.0,-265196.0
2009-10-24,91232,91232,0,-1,-0.0,-265196.0
2009-10-25,91232,94702,3470,0,0.0,-265196.0
2009-10-26,94702,91232,-3470,0,-0.0,-265196.0
2009-10-27,91232,87558,-3674,-1,3674.0,-261522.0
2009-10-28,87558,85823,-1735,0,-0.0,-261522.0
2009-10-29,85823,85517,-306,0,-0.0,-261522.0
2009-10-30,85517,85517,0,-1,-0.0,-261522.0
2009-10-31,85517,85517,0,0,0.0,-261522.0
2009-11-01,85517,84089,-1428,0,-0.0,-261522.0
2009-11-02,84089,83272,-817,1,-817.0,-262339.0
2009-11-03,83272,83578,306,-1,-306.0,-262645.0
2009-11-04,83578,75823,-7755,0,-0.0,-262645.0
2009-11-05,75823,74598,-1225,0,-0.0,-262645.0
2009-11-06,74598,74598,0,0,0.0,-262645.0
2009-11-07,74598,74598,0,1,0.0,-262645.0
2009-11-08,74598,76027,1429,0,0.0,-262645.0
2009-11-09,76027,75925,-102,1,-102.0,-262747.0
2009-11-10,75925,75720,-205,1,-205.0,-262952.0
2009-11-11,75720,76639,919,0,0.0,-262952.0
2009-11-12,76639,77966,1327,-1,-1327.0,-264279.0
2009-11-13,77966,77966,0,-1,-0.0,-264279.0
2009-11-14,77966,77966,0,0,0.0,-264279.0
2009-11-15,77966,78782,816,-1,-816.0,-265095.0
2009-11-16,78782,80619,1837,1,1837.0,-263258.0
2009-11-17,80619,79292,-1327,1,-1327.0,-264585.0
2009-11-18,79292,77864,-1428,-1,1428.0,-263157.0
2009-11-19,77864,77761,-103,0,-0.0,-263157.0
2009-11-20,77761,77761,0,0,0.0,-263157.0
2009-11-21,77761,77761,0,-1,-0.0,-263157.0
2009-11-22,77761,76333,-1428,1,-1428.0,-264585.0
2009-11-23,76333,76129,-204,-1,204.0,-264381.0
2009-11-24,76129,76027,-102,1,-102.0,-264483.0
2009-11-25,76027,76027,0,1,0.0,-264483.0
2009-11-26,76027,70210,-5817,-1,5817.0,-258666.0
2009-11-27,70210,70210,0,0,0.0,-258666.0
2009-11-28,70210,70210,0,-1,-0.0,-258666.0
2009-11-29,70210,71536,1326,1,1326.0,-257340.0
2009-11-30,71536,67863,-3673,-1,3673.0,-253667.0
2009-12-01,67863,67352,-511,0,-0.0,-253667.0
2009-12-02,67352,71945,4593,0,0.0,-253667.0
2009-12-03,71945,71843,-102,0,-0.0,-253667.0
2009-12-04,71843,71843,0,-1,-0.0,-253667.0
2009-12-05,71843,71843,0,1,0.0,-253667.0
2009-12-06,71843,74802,2959,0,0.0,-253667.0
2009-12-07,74802,74802,0,0,0.0,-253667.0
2009-12-08,74802,74802,0,-1,-0.0,-253667.0
2009-12-09,74802,77761,2959,1,2959.0,-250708.0
2009-12-10,77761,79394,1633,0,0.0,-250708.0
2009-12-11,79394,79394,0,0,0.0,-250708.0
2009-12-12,79394,79394,0,0,0.0,-250708.0
2009-12-13,79394,79802,408,0,0.0,-250708.0
2009-12-14,79802,80823,1021,-1,-1021.0,-251729.0
2009-12-15,80823,79394,-1429,0,-0.0,-251729.0
2009-12-16,79394,80109,715,-1,-715.0,-252444.0
2009-12-17,80109,79496,-613,0,-0.0,-252444.0
2009-12-18,79496,79496,0,0,0.0,-252444.0
2009-12-19,79496,79496,0,-1,-0.0,-252444.0
2009-12-20,79496,79598,102,-1,-102.0,-252546.0
2009-12-21,79598,87252,7654,-1,-7654.0,-260200.0
2009-12-22,87252,85823,-1429,0,-0.0,-260200.0
2009-12-23,85823,88273,2450,0,0.0,-260200.0
2009-12-24,88273,88273,0,0,0.0,-260200.0
2009-12-25,88273,88273,0,-1,-0.0,-260200.0
2009-12-26,88273,88273,0,1,0.0,-260200.0
2009-12-27,88273,101437,13164,-1,-13164.0,-273364.0
2009-12-28,101437,97661,-3776,-1,3776.0,-269588.0
2009-12-29,97661,97355,-306,0,-0.0,-269588.0
2009-12-30,97355,97355,0,1,0.0,-269588.0
2009-12-31,97355,97355,0,1,0.0,-269588.0
2010-01-01,97355,97355,0,-1,-0.0,-269588.0
2010-01-02,97355,97355,0,0,0.0,-269588.0
2010-01-03,97355,94804,-2551,-1,2551.0,-267037.0
2010-01-04,94804,94600,-204,-1,204.0,-266833.0
2010-01-05,94600,99804,5204,0,0.0,-266833.0
2010-01-06,99804,102559,2755,1,2755.0,-264078.0
2010-01-07,102559,109193,6634,1,6634.0,-257444.0
2010-01-08,109193,109193,0,-1,-0.0,-257444.0
2010-01-09,109193,109193,0,1,0.0,-257444.0
2010-01-10,109193,107662,-1531,-1,1531.0,-255913.0
2010-01-11,107662,112764,5102,0,0.0,-255913.0
2010-01-12,112764,110213,-2551,0,-0.0,-255913.0
2010-01-13,110213,109193,-1020,0,-0.0,-255913.0
2010-01-14,109193,115316,6123,0,0.0,-255913.0
2010-01-15,115316,115316,0,0,0.0,-255913.0
2010-01-16,115316,115316,0,-1,-0.0,-255913.0
2010-01-17,115316,121439,6123,-1,-6123.0,-262036.0
2010-01-18,121439,122969,1530,-1,-1530.0,-263566.0
2010-01-19,122969,125010,2041,0,0.0,-263566.0
2010-01-20,125010,119908,-5102,1,-5102.0,-268668.0
2010-01-21,119908,117867,-2041,1,-2041.0,-270709.0
2010-01-22,117867,117867,0,0,0.0,-270709.0
2010-01-23,117867,117867,0,1,0.0,-270709.0
2010-01-24,117867,112764,-5103,0,-0.0,-270709.0
2010-01-25,112764,106131,-6633,-1,6633.0,-264076.0
2010-01-26,106131,106641,510,0,0.0,-264076.0
2010-01-27,106641,109193,2552,-1,-2552.0,-266628.0
2010-01-28,109193,104600,-4593,1,-4593.0,-271221.0
2010-01-29,104600,104600,0,0,0.0,-271221.0
2010-01-30,104600,104600,0,1,0.0,-271221.0
2010-01-31,104600,103580,-1020,1,-1020.0,-272241.0
2010-02-01,103580,103070,-510,0,-0.0,-272241.0
2010-02-02,103070,105111,2041,1,2041.0,-270200.0
2010-02-03,105111,106641,1530,1,1530.0,-268670.0
2010-02-04,106641,101335,-5306,1,-5306.0,-273976.0
2010-02-05,101335,101335,0,1,0.0,-273976.0
2010-02-06,101335,101335,0,-1,-0.0,-273976.0
2010-02-07,101335,101641,306,1,306.0,-273670.0
2010-02-08,101641,103070,1429,1,1429.0,-272241.0
2010-02-09,103070,104600,1530,-1,-1530.0,-273771.0
2010-02-10,104600,105621,1021,1,1021.0,-272750.0
2010-02-11,105621,106641,1020,0,0.0,-272750.0
2010-02-12,106641,106641,0,-1,-0.0,-272750.0
2010-02-13,106641,106641,0,1,0.0,-272750.0
2010-02-14,106641,106641,0,-1,-0.0,-272750.0
2010-02-15,106641,107152,511,1,511.0,-272239.0
2010-02-16,107152,106641,-511,-1,511.0,-271728.0
2010-02-17,106641,109193,2552,0,0.0,-271728.0
2010-02-18,109193,109703,510,1,510.0,-271218.0
2010-02-19,109703,109703,0,1,0.0,-271218.0
2010-02-20,109703,109703,0,0,0.0,-271218.0
2010-02-21,109703,112254,2551,0,0.0,-271218.0
2010-02-22,112254,113275,1021,1,1021.0,-270197.0
2010-02-23,113275,115826,2551,-1,-2551.0,-272748.0
2010-02-24,115826,111234,-4592,-1,4592.0,-268156.0
2010-02-25,111234,110213,-1021,0,-0.0,-268156.0
2010-02-26,110213,110213,0,1,0.0,-268156.0
2010-02-27,110213,110213,0,0,0.0,-268156.0
2010-02-28,110213,110213,0,0,0.0,-268156.0
2010-03-01,110213,108682,-1531,-1,1531.0,-266625.0
2010-03-02,108682,108682,0,0,0.0,-266625.0
2010-03-03,108682,107662,-1020,-1,1020.0,-265605.0
2010-03-04,107662,110723,3061,1,3061.0,-262544.0
2010-03-05,110723,110723,0,1,0.0,-262544.0
2010-03-06,110723,110723,0,0,0.0,-262544.0
2010-03-07,110723,114805,4082,1,4082.0,-258462.0
2010-03-08,114805,116846,2041,0,0.0,-258462.0
2010-03-09,116846,118377,1531,1,1531.0,-256931.0
2010-03-10,118377,116846,-1531,1,-1531.0,-258462.0
2010-03-11,116846,119398,2552,-1,-2552.0,-261014.0
2010-03-12,119398,119398,0,1,0.0,-261014.0
2010-03-13,119398,119398,0,1,0.0,-261014.0
2010-03-14,119398,117357,-2041,-1,2041.0,-258973.0
2010-03-15,117357,114805,-2552,-1,2552.0,-256421.0
2010-03-16,114805,116846,2041,1,2041.0,-254380.0
2010-03-17,116846,118377,1531,0,0.0,-254380.0
2010-03-18,118377,118887,510,1,510.0,-253870.0
2010-03-19,118887,118887,0,0,0.0,-253870.0
2010-03-20,118887,118887,0,-1,-0.0,-253870.0
2010-03-21,118887,117357,-1530,0,-0.0,-253870.0
2010-03-22,117357,117867,510,-1,-510.0,-254380.0
2010-03-23,117867,118377,510,1,510.0,-253870.0
2010-03-24,118377,118887,510,-1,-510.0,-254380.0
2010-03-25,118887,119398,511,0,0.0,-254380.0
2010-03-26,119398,119398,0,1,0.0,-254380.0
2010-03-27,119398,119398,0,0,0.0,-254380.0
2010-03-28,119398,120418,1020,-1,-1020.0,-255400.0
2010-03-29,120418,126541,6123,0,0.0,-255400.0
2010-03-30,126541,131133,4592,1,4592.0,-250808.0
2010-03-31,131133,130113,-1020,-1,1020.0,-249788.0
2010-04-01,130113,133684,3571,1,3571.0,-246217.0
2010-04-02,133684,133684,0,0,0.0,-246217.0
2010-04-03,133684,133684,0,-1,-0.0,-246217.0
2010-04-04,133684,135215,1531,0,0.0,-246217.0
2010-04-05,135215,138277,3062,0,0.0,-246217.0
2010-04-06,138277,136746,-1531,1,-1531.0,-247748.0
2010-04-07,136746,136746,0,1,0.0,-247748.0
2010-04-08,136746,136746,0,1,0.0,-247748.0
2010-04-09,136746,136746,0,0,0.0,-247748.0
2010-04-10,136746,136746,0,1,0.0,-247748.0
2010-04-11,136746,136236,-510,0,-0.0,-247748.0
2010-04-12,136236,134705,-1531,0,-0.0,-247748.0
2010-04-13,134705,132664,-2041,-1,2041.0,-245707.0
2010-04-14,132664,130113,-2551,-1,2551.0,-243156.0
2010-04-15,130113,130623,510,1,510.0,-242646.0
2010-04-16,130623,130623,0,0,0.0,-242646.0
2010-04-17,130623,130623,0,0,0.0,-242646.0
2010-04-18,130623,127561,-3062,1,-3062.0,-245708.0
2010-04-19,127561,129092,1531,0,0.0,-245708.0
2010-04-20,129092,129602,510,0,0.0,-245708.0
2010-04-21,129602,125010,-4592,0,-0.0,-245708.0
2010-04-22,125010,123480,-1530,-1,1530.0,-244178.0
2010-04-23,123480,123480,0,1,0.0,-244178.0
2010-04-24,123480,123480,0,1,0.0,-244178.0
2010-04-25,123480,123480,0,-1,-0.0,-244178.0
2010-04-26,123480,131133,7653,1,7653.0,-236525.0
2010-04-27,131133,131133,0,-1,-0.0,-236525.0
2010-04-28,131133,122969,-8164,0,-0.0,-236525.0
2010-04-29,122969,125010,2041,-1,-2041.0,-238566.0
2010-04-30,125010,125010,0,-1,-0.0,-238566.0
2010-05-01,125010,125010,0,1,0.0,-238566.0
2010-05-02,125010,109193,-15817,1,-15817.0,-254383.0
2010-05-03,109193,109703,510,-1,-510.0,-254893.0
2010-05-04,109703,109703,0,0,0.0,-254893.0
2010-05-05,109703,104090,-5613,1,-5613.0,-260506.0
2010-05-06,104090,103580,-510,1,-510.0,-261016.0
2010-05-07,103580,103580,0,1,0.0,-261016.0
2010-05-08,103580,103580,0,-1,-0.0,-261016.0
2010-05-09,103580,110213,6633,-1,-6633.0,-267649.0
2010-05-10,110213,101845,-8368,-1,8368.0,-259281.0
2010-05-11,101845,101743,-102,1,-102.0,-259383.0
2010-05-12,101743,101641,-102,-1,102.0,-259281.0
2010-05-13,101641,94293,-7348,-1,7348.0,-251933.0
2010-05-14,94293,94293,0,0,0.0,-251933.0
2010-05-15,94293,94293,0,1,0.0,-251933.0
2010-05-16,94293,93375,-918,0,-0.0,-251933.0
2010-05-17,93375,93375,0,0,0.0,-251933.0
2010-05-18,93375,94293,918,-1,-918.0,-252851.0
2010-05-19,94293,89089,-5204,0,-0.0,-252851.0
2010-05-20,89089,89089,0,0,0.0,-252851.0
2010-05-21,89089,89089,0,-1,-0.0,-252851.0
2010-05-22,89089,89089,0,0,0.0,-252851.0
2010-05-23,89089,89701,612,1,612.0,-252239.0
2010-05-24,89701,84701,-5000,1,-5000.0,-257239.0
2010-05-25,84701,83782,-919,0,-0.0,-257239.0
2010-05-26,83782,90824,7042,0,0.0,-257239.0
2010-05-27,90824,92967,2143,-1,-2143.0,-259382.0
2010-05-28,92967,92967,0,1,0.0,-259382.0
2010-05-29,92967,92967,0,1,0.0,-259382.0
2010-05-30,92967,97661,4694,0,0.0,-259382.0
2010-05-31,97661,98477,816,-1,-816.0,-260198.0
2010-06-01,98477,98477,0,1,0.0,-260198.0
2010-06-02,98477,98682,205,-1,-205.0,-260403.0
2010-06-03,98682,101131,2449,1,2449.0,-257954.0
2010-06-04,101131,101131,0,-1,-0.0,-257954.0
2010-06-05,101131,101131,0,0,0.0,-257954.0
2010-06-06,101131,95824,-5307,1,-5307.0,-263261.0
2010-06-07,95824,95314,-510,0,-0.0,-263261.0
2010-06-08,95314,97559,2245,-1,-2245.0,-265506.0
2010-06-09,97559,98171,612,1,612.0,-264894.0
2010-06-10,98171,101437,3266,1,3266.0,-261628.0
2010-06-11,101437,101437,0,1,0.0,-261628.0
2010-06-12,101437,101437,0,1,0.0,-261628.0
2010-06-13,101437,99906,-1531,1,-1531.0,-263159.0
2010-06-14,99906,100110,204,1,204.0,-262955.0
2010-06-15,100110,101437,1327,-1,-1327.0,-264282.0
2010-06-16,101437,97967,-3470,1,-3470.0,-267752.0
2010-06-17,97967,99396,1429,0,0.0,-267752.0
2010-06-18,99396,99396,0,-1,-0.0,-267752.0
2010-06-19,99396,99396,0,0,0.0,-267752.0
2010-06-20,99396,104600,5204,-1,-5204.0,-272956.0
2010-06-21,104600,108172,3572,0,0.0,-272956.0
2010-06-22,108172,106641,-1531,1,-1531.0,-274487.0
2010-06-23,106641,109193,2552,1,2552.0,-271935.0
2010-06-24,109193,108172,-1021,1,-1021.0,-272956.0
2010-06-25,108172,108172,0,1,0.0,-272956.0
2010-06-26,108172,108172,0,0,0.0,-272956.0
2010-06-27,108172,110723,2551,-1,-2551.0,-275507.0
2010-06-28,110723,111234,511,0,0.0,-275507.0
2010-06-29,111234,113785,2551,0,0.0,-275507.0
2010-06-30,113785,115316,1531,-1,-1531.0,-277038.0
2010-07-01,115316,107662,-7654,0,-0.0,-277038.0
2010-07-02,107662,107662,0,0,0.0,-277038.0
2010-07-03,107662,107662,0,-1,-0.0,-277038.0
2010-07-04,107662,109193,1531,0,0.0,-277038.0
2010-07-05,109193,107662,-1531,0,-0.0,-277038.0
2010-07-06,107662,101131,-6531,-1,6531.0,-270507.0
2010-07-07,101131,101029,-102,1,-102.0,-270609.0
2010-07-08,101029,103070,2041,1,2041.0,-268568.0
2010-07-09,103070,103070,0,0,0.0,-268568.0
2010-07-10,103070,103070,0,1,0.0,-268568.0
2010-07-11,103070,102049,-1021,0,-0.0,-268568.0
2010-07-12,102049,108172,6123,-1,-6123.0,-274691.0
2010-07-13,108172,111744,3572,-1,-3572.0,-278263.0
2010-07-14,111744,110723,-1021,-1,1021.0,-277242.0
2010-07-15,110723,107152,-3571,-1,3571.0,-273671.0
2010-07-16,107152,107152,0,0,0.0,-273671.0
2010-07-17,107152,107152,0,0,0.0,-273671.0
2010-07-18,107152,114295,7143,1,7143.0,-266528.0
2010-07-19,114295,113275,-1020,1,-1020.0,-267548.0
2010-07-20,113275,117357,4082,-1,-4082.0,-271630.0
2010-07-21,117357,120418,3061,-1,-3061.0,-274691.0
2010-07-22,120418,125010,4592,0,0.0,-274691.0
2010-07-23,125010,125010,0,1,0.0,-274691.0
2010-07-24,125010,125010,0,-1,-0.0,-274691.0
2010-07-25,125010,123480,-1530,-1,1530.0,-273161.0
2010-07-26,123480,124500,1020,1,1020.0,-272141.0
2010-07-27,124500,120418,-4082,-1,4082.0,-268059.0
2010-07-28,120418,120418,0,1,0.0,-268059.0
2010-07-29,120418,116846,-3572,1,-3572.0,-271631.0
2010-07-30,116846,116846,0,1,0.0,-271631.0
2010-07-31,116846,116846,0,1,0.0,-271631.0
2010-08-01,116846,119398,2552,0,0.0,-271631.0
2010-08-02,119398,123480,4082,-1,-4082.0,-275713.0
2010-08-03,123480,120418,-3062,1,-3062.0,-278775.0
2010-08-04,120418,119908,-510,0,-0.0,-278775.0
2010-08-05,119908,119398,-510,-1,510.0,-278265.0
2010-08-06,119398,119398,0,0,0.0,-278265.0
2010-08-07,119398,119398,0,0,0.0,-278265.0
2010-08-08,119398,127561,8163,1,8163.0,-270102.0
2010-08-09,127561,130623,3062,-1,-3062.0,-273164.0
2010-08-10,130623,130623,0,1,0.0,-273164.0
2010-08-11,130623,127561,-3062,-1,3062.0,-270102.0
2010-08-12,127561,132664,5103,1,5103.0,-264999.0
2010-08-13,132664,132664,0,1,0.0,-264999.0
2010-08-14,132664,132664,0,-1,-0.0,-264999.0
2010-08-15,132664,132664,0,0,0.0,-264999.0
2010-08-16,132664,136236,3572,-1,-3572.0,-268571.0
2010-08-17,136236,131133,-5103,1,-5103.0,-273674.0
2010-08-18,131133,128072,-3061,-1,3061.0,-270613.0
2010-08-19,128072,129092,1020,-1,-1020.0,-271633.0
2010-08-20,129092,129092,0,0,0.0,-271633.0
2010-08-21,129092,129092,0,-1,-0.0,-271633.0
2010-08-22,129092,130113,1021,0,0.0,-271633.0
2010-08-23,130113,128582,-1531,0,-0.0,-271633.0
2010-08-24,128582,120928,-7654,-1,7654.0,-263979.0
2010-08-25,120928,116846,-4082,-1,4082.0,-259897.0
2010-08-26,116846,115316,-1530,1,-1530.0,-261427.0
2010-08-27,115316,115316,0,0,0.0,-261427.0
2010-08-28,115316,115316,0,0,0.0,-261427.0
2010-08-29,115316,121439,6123,-1,-6123.0,-267550.0
2010-08-30,121439,122459,1020,0,0.0,-267550.0
2010-08-31,122459,123480,1021,-1,-1021.0,-268571.0
2010-09-01,123480,118887,-4593,0,-0.0,-268571.0
2010-09-02,118887,120418,1531,1,1531.0,-267040.0
2010-09-03,120418,120418,0,-1,-0.0,-267040.0
2010-09-04,120418,120418,0,-1,-0.0,-267040.0
2010-09-05,120418,123480,3062,0,0.0,-267040.0
2010-09-06,123480,121949,-1531,-1,1531.0,-265509.0
2010-09-07,121949,119398,-2551,0,-0.0,-265509.0
2010-09-08,119398,120928,1530,0,0.0,-265509.0
2010-09-09,120928,126541,5613,-1,-5613.0,-271122.0
2010-09-10,126541,126541,0,0,0.0,-271122.0
2010-09-11,126541,126541,0,0,0.0,-271122.0
2010-09-12,126541,127561,1020,-1,-1020.0,-272142.0
2010-09-13,127561,131133,3572,1,3572.0,-268570.0
2010-09-14,131133,134195,3062,1,3062.0,-265508.0
2010-09-15,134195,133684,-511,-1,511.0,-264997.0
2010-09-16,133684,134195,511,1,511.0,-264486.0
2010-09-17,134195,134195,0,-1,-0.0,-264486.0
2010-09-18,134195,134195,0,0,0.0,-264486.0
2010-09-19,134195,136236,2041,1,2041.0,-262445.0
2010-09-20,136236,136236,0,0,0.0,-262445.0
2010-09-21,136236,136236,0,1,0.0,-262445.0
2010-09-22,136236,136236,0,-1,-0.0,-262445.0
2010-09-23,136236,140828,4592,0,0.0,-262445.0
2010-09-24,140828,140828,0,1,0.0,-262445.0
2010-09-25,140828,140828,0,1,0.0,-262445.0
2010-09-26,140828,150523,9695,0,0.0,-262445.0
2010-09-27,150523,148992,-1531,0,-0.0,-262445.0
2010-09-28,148992,153074,4082,1,4082.0,-258363.0
2010-09-29,153074,155625,2551,-1,-2551.0,-260914.0
2010-09-30,155625,150523,-5102,1,-5102.0,-266016.0
2010-10-01,150523,150523,0,0,0.0,-266016.0
2010-10-02,150523,150523,0,-1,-0.0,-266016.0
2010-10-03,150523,157156,6633,-1,-6633.0,-272649.0
2010-10-04,157156,155625,-1531,0,-0.0,-272649.0
2010-10-05,155625,154094,-1531,1,-1531.0,-274180.0
2010-10-06,154094,170422,16328,0,0.0,-274180.0
2010-10-07,170422,167871,-2551,0,-0.0,-274180.0
2010-10-08,167871,167871,0,1,0.0,-274180.0
2010-10-09,167871,167871,0,0,0.0,-274180.0
2010-10-10,167871,173484,5613,1,5613.0,-268567.0
2010-10-11,173484,172463,-1021,0,-0.0,-268567.0
2010-10-12,172463,160727,-11736,1,-11736.0,-280303.0
2010-10-13,160727,162258,1531,-1,-1531.0,-281834.0
2010-10-14,162258,166850,4592,1,4592.0,-277242.0
2010-10-15,166850,166850,0,0,0.0,-277242.0
2010-10-16,166850,166850,0,1,0.0,-277242.0
2010-10-17,166850,161748,-5102,-1,5102.0,-272140.0
2010-10-18,161748,156645,-5103,0,-0.0,-272140.0
2010-10-19,156645,157666,1021,0,0.0,-272140.0
2010-10-20,157666,158176,510,-1,-510.0,-272650.0
2010-10-21,158176,160727,2551,1,2551.0,-270099.0
2010-10-22,160727,160727,0,0,0.0,-270099.0
2010-10-23,160727,160727,0,0,0.0,-270099.0
2010-10-24,160727,163279,2552,0,0.0,-270099.0
2010-10-25,163279,168891,5612,1,5612.0,-264487.0
2010-10-26,168891,168381,-510,0,-0.0,-264487.0
2010-10-27,168381,162768,-5613,0,-0.0,-264487.0
2010-10-28,162768,154605,-8163,1,-8163.0,-272650.0
2010-10-29,154605,154605,0,-1,-0.0,-272650.0
2010-10-30,154605,154605,0,-1,-0.0,-272650.0
2010-10-31,154605,158176,3571,0,0.0,-272650.0
2010-11-01,158176,162258,4082,-1,-4082.0,-276732.0
2010-11-02,162258,160727,-1531,0,-0.0,-276732.0
2010-11-03,160727,154094,-6633,1,-6633.0,-283365.0
2010-11-04,154094,145930,-8164,1,-8164.0,-291529.0
2010-11-05,145930,145930,0,-1,-0.0,-291529.0
2010-11-06,145930,145930,0,1,0.0,-291529.0
2010-11-07,145930,148482,2552,-1,-2552.0,-294081.0
2010-11-08,148482,151033,2551,0,0.0,-294081.0
2010-11-09,151033,152053,1020,-1,-1020.0,-295101.0
2010-11-10,152053,147461,-4592,0,-0.0,-295101.0
2010-11-11,147461,146951,-510,-1,510.0,-294591.0
2010-11-12,146951,146951,0,-1,-0.0,-294591.0
2010-11-13,146951,146951,0,1,0.0,-294591.0
2010-11-14,146951,139297,-7654,0,-0.0,-294591.0
2010-11-15,139297,132154,-7143,-1,7143.0,-287448.0
2010-11-16,132154,136236,4082,1,4082.0,-283366.0
2010-11-17,136236,144400,8164,0,0.0,-283366.0
2010-11-18,144400,144400,0,-1,-0.0,-283366.0
2010-11-19,144400,144400,0,0,0.0,-283366.0
2010-11-20,144400,144400,0,-1,-0.0,-283366.0
2010-11-21,144400,143379,-1021,1,-1021.0,-284387.0
2010-11-22,143379,138277,-5102,0,-0.0,-284387.0
2010-11-23,138277,138787,510,0,0.0,-284387.0
2010-11-24,138787,138277,-510,1,-510.0,-284897.0
2010-11-25,138277,140828,2551,0,0.0,-284897.0
2010-11-26,140828,140828,0,1,0.0,-284897.0
2010-11-27,140828,140828,0,1,0.0,-284897.0
2010-11-28,140828,141338,510,1,510.0,-284387.0
2010-11-29,141338,143379,2041,-1,-2041.0,-286428.0
2010-11-30,143379,145420,2041,1,2041.0,-284387.0
2010-12-01,145420,147461,2041,1,2041.0,-282346.0
2010-12-02,147461,142869,-4592,-1,4592.0,-277754.0
2010-12-03,142869,142869,0,1,0.0,-277754.0
2010-12-04,142869,142869,0,-1,-0.0,-277754.0
2010-12-05,142869,136236,-6633,-1,6633.0,-271121.0
2010-12-06,136236,140318,4082,1,4082.0,-267039.0
2010-12-07,140318,144400,4082,0,0.0,-267039.0
2010-12-08,144400,148992,4592,0,0.0,-267039.0
2010-12-09,148992,151033,2041,0,0.0,-267039.0
2010-12-10,151033,151033,0,-1,-0.0,-267039.0
2010-12-11,151033,151033,0,0,0.0,-267039.0
2010-12-12,151033,147461,-3572,-1,3572.0,-263467.0
2010-12-13,147461,150523,3062,0,0.0,-263467.0
2010-12-14,150523,151543,1020,0,0.0,-263467.0
2010-12-15,151543,149502,-2041,0,-0.0,-263467.0
2010-12-16,149502,156645,7143,-1,-7143.0,-270610.0
2010-12-17,156645,156645,0,0,0.0,-270610.0
2010-12-18,156645,156645,0,0,0.0,-270610.0
2010-12-19,156645,159197,2552,-1,-2552.0,-273162.0
2010-12-20,159197,158176,-1021,-1,1021.0,-272141.0
2010-12-21,158176,156135,-2041,-1,2041.0,-270100.0
2010-12-22,156135,157156,1021,0,0.0,-270100.0
2010-12-23,157156,159707,2551,1,2551.0,-267549.0
2010-12-24,159707,159707,0,-1,-0.0,-267549.0
2010-12-25,159707,159707,0,1,0.0,-267549.0
2010-12-26,159707,151543,-8164,1,-8164.0,-275713.0
2010-12-27,151543,150012,-1531,-1,1531.0,-274182.0
2010-12-28,150012,155625,5613,0,0.0,-274182.0
2010-12-29,155625,157156,1531,0,0.0,-274182.0
2010-12-30,157156,157156,0,1,0.0,-274182.0
2010-12-31,157156,157156,0,1,0.0,-274182.0
2011-01-01,157156,157156,0,-1,-0.0,-274182.0
2011-01-02,157156,160727,3571,0,0.0,-274182.0
2011-01-03,160727,161238,511,1,511.0,-273671.0
2011-01-04,161238,158686,-2552,1,-2552.0,-276223.0
2011-01-05,158686,157156,-1530,1,-1530.0,-277753.0
2011-01-06,157156,157666,510,1,510.0,-277243.0
2011-01-07,157666,157666,0,0,0.0,-277243.0
2011-01-08,157666,157666,0,-1,-0.0,-277243.0
2011-01-09,157666,156135,-1531,0,-0.0,-277243.0
2011-01-10,156135,157156,1021,0,0.0,-277243.0
2011-01-11,157156,165830,8674,0,0.0,-277243.0
2011-01-12,165830,165320,-510,0,-0.0,-277243.0
2011-01-13,165320,168891,3571,1,3571.0,-273672.0
2011-01-14,168891,168891,0,0,0.0,-273672.0
2011-01-15,168891,168891,0,-1,-0.0,-273672.0
2011-01-16,168891,168891,0,0,0.0,-273672.0
2011-01-17,168891,168381,-510,-1,510.0,-273162.0
2011-01-18,168381,168381,0,-1,-0.0,-273162.0
2011-01-19,168381,165320,-3061,0,-0.0,-273162.0
2011-01-20,165320,158686,-6634,-1,6634.0,-266528.0
2011-01-21,158686,158686,0,-1,-0.0,-266528.0
2011-01-22,158686,158686,0,0,0.0,-266528.0
2011-01-23,158686,159197,511,0,0.0,-266528.0
2011-01-24,159197,159197,0,0,0.0,-266528.0
2011-01-25,159197,162258,3061,-1,-3061.0,-269589.0
2011-01-26,162258,166340,4082,1,4082.0,-265507.0
2011-01-27,166340,170932,4592,-1,-4592.0,-270099.0
2011-01-28,170932,170932,0,1,0.0,-270099.0
2011-01-29,170932,170932,0,-1,-0.0,-270099.0
2011-01-30,170932,170422,-510,0,-0.0,-270099.0
2011-01-31,170422,167361,-3061,-1,3061.0,-267038.0
2011-02-01,167361,167361,0,-1,-0.0,-267038.0
2011-02-02,167361,167361,0,-1,-0.0,-267038.0
2011-02-03,167361,167361,0,0,0.0,-267038.0
2011-02-04,167361,167361,0,0,0.0,-267038.0
2011-02-05,167361,167361,0,1,0.0,-267038.0
2011-02-06,167361,166340,-1021,0,-0.0,-267038.0
2011-02-07,166340,161238,-5102,1,-5102.0,-272140.0
2011-02-08,161238,158686,-2552,-1,2552.0,-269588.0
2011-02-09,158686,157156,-1530,-1,1530.0,-268058.0
2011-02-10,157156,155115,-2041,-1,2041.0,-266017.0
2011-02-11,155115,155115,0,1,0.0,-266017.0
2011-02-12,155115,155115,0,0,0.0,-266017.0
2011-02-13,155115,156645,1530,0,0.0,-266017.0
2011-02-14,156645,153074,-3571,0,-0.0,-266017.0
2011-02-15,153074,150523,-2551,0,-0.0,-266017.0
2011-02-16,150523,138277,-12246,0,-0.0,-266017.0
2011-02-17,138277,141338,3061,1,3061.0,-262956.0
2011-02-18,141338,141338,0,0,0.0,-262956.0
2011-02-19,141338,141338,0,0,0.0,-262956.0
2011-02-20,141338,137256,-4082,1,-4082.0,-267038.0
2011-02-21,137256,128072,-9184,0,-0.0,-267038.0
2011-02-22,128072,127561,-511,0,-0.0,-267038.0
2011-02-23,127561,127561,0,0,0.0,-267038.0
2011-02-24,127561,132664,5103,1,5103.0,-261935.0
2011-02-25,132664,132664,0,-1,-0.0,-261935.0
2011-02-26,132664,132664,0,-1,-0.0,-261935.0
2011-02-27,132664,127561,-5103,1,-5103.0,-267038.0
2011-02-28,127561,127561,0,1,0.0,-267038.0
2011-03-01,127561,127051,-510,1,-510.0,-267548.0
2011-03-02,127051,130113,3062,0,0.0,-267548.0
2011-03-03,130113,132664,2551,-1,-2551.0,-270099.0
2011-03-04,132664,132664,0,-1,-0.0,-270099.0
2011-03-05,132664,132664,0,1,0.0,-270099.0
2011-03-06,132664,133174,510,1,510.0,-269589.0
2011-03-07,133174,133684,510,1,510.0,-269079.0
2011-03-08,133684,133684,0,0,0.0,-269079.0
2011-03-09,133684,136746,3062,0,0.0,-269079.0
2011-03-10,136746,133684,-3062,-1,3062.0,-266017.0
2011-03-11,133684,133684,0,1,0.0,-266017.0
2011-03-12,133684,133684,0,-1,-0.0,-266017.0
2011-03-13,133684,126031,-7653,0,-0.0,-266017.0
2011-03-14,126031,124500,-1531,-1,1531.0,-264486.0
2011-03-15,124500,127051,2551,1,2551.0,-261935.0
2011-03-16,127051,130623,3572,-1,-3572.0,-265507.0
2011-03-17,130623,133684,3061,1,3061.0,-262446.0
2011-03-18,133684,133684,0,0,0.0,-262446.0
2011-03-19,133684,133684,0,0,0.0,-262446.0
2011-03-20,133684,137766,4082,1,4082.0,-258364.0
2011-03-21,137766,137766,0,-1,-0.0,-258364.0
2011-03-22,137766,138787,1021,-1,-1021.0,-259385.0
2011-03-23,138787,140318,1531,-1,-1531.0,-260916.0
2011-03-24,140318,140318,0,0,0.0,-260916.0
2011-03-25,140318,140318,0,1,0.0,-260916.0
2011-03-26,140318,140318,0,1,0.0,-260916.0
2011-03-27,140318,137256,-3062,0,-0.0,-260916.0
2011-03-28,137256,137766,510,1,510.0,-260406.0
2011-03-29,137766,141338,3572,0,0.0,-260406.0
2011-03-30,141338,145930,4592,0,0.0,-260406.0
2011-03-31,145930,146951,1021,1,1021.0,-259385.0
2011-04-01,146951,146951,0,1,0.0,-259385.0
2011-04-02,146951,146951,0,-1,-0.0,-259385.0
2011-04-03,146951,147461,510,-1,-510.0,-259895.0
2011-04-04,147461,148482,1021,-1,-1021.0,-260916.0
2011-04-05,148482,148992,510,1,510.0,-260406.0
2011-04-06,148992,146441,-2551,1,-2551.0,-262957.0
2011-04-07,146441,146951,510,1,510.0,-262447.0
2011-04-08,146951,146951,0,1,0.0,-262447.0
2011-04-09,146951,146951,0,1,0.0,-262447.0
2011-04-10,146951,146951,0,-1,-0.0,-262447.0
2011-04-11,146951,142869,-4082,1,-4082.0,-266529.0
2011-04-12,142869,142359,-510,-1,510.0,-266019.0
2011-04-13,142359,141848,-511,1,-511.0,-266530.0
2011-04-14,141848,143379,1531,-1,-1531.0,-268061.0
2011-04-15,143379,143379,0,0,0.0,-268061.0
2011-04-16,143379,143379,0,1,0.0,-268061.0
2011-04-17,143379,138787,-4592,-1,4592.0,-263469.0
2011-04-18,138787,136746,-2041,1,-2041.0,-265510.0
2011-04-19,136746,137766,1020,1,1020.0,-264490.0
2011-04-20,137766,132664,-5102,0,-0.0,-264490.0
2011-04-21,132664,134705,2041,0,0.0,-264490.0
2011-04-22,134705,134705,0,0,0.0,-264490.0
2011-04-23,134705,134705,0,0,0.0,-264490.0
2011-04-24,134705,137256,2551,-1,-2551.0,-267041.0
2011-04-25,137256,135725,-1531,0,-0.0,-267041.0
2011-04-26,135725,134705,-1020,-1,1020.0,-266021.0
2011-04-27,134705,134705,0,-1,-0.0,-266021.0
2011-04-28,134705,134195,-510,1,-510.0,-266531.0
2011-04-29,134195,134195,0,0,0.0,-266531.0
2011-04-30,134195,134195,0,1,0.0,-266531.0
2011-05-01,134195,142869,8674,-1,-8674.0,-275205.0
2011-05-02,142869,143889,1020,0,0.0,-275205.0
2011-05-03,143889,148992,5103,-1,-5103.0,-280308.0
2011-05-04,148992,148992,0,1,0.0,-280308.0
2011-05-05,148992,148992,0,0,0.0,-280308.0
2011-05-06,148992,148992,0,0,0.0,-280308.0
2011-05-07,148992,148992,0,-1,-0.0,-280308.0
2011-05-08,148992,146951,-2041,-1,2041.0,-278267.0
2011-05-09,146951,146951,0,-1,-0.0,-278267.0
2011-05-10,146951,148992,2041,-1,-2041.0,-280308.0
2011-05-11,148992,147461,-1531,1,-1531.0,-281839.0
2011-05-12,147461,146951,-510,0,-0.0,-281839.0
2011-05-13,146951,146951,0,0,0.0,-281839.0
2011-05-14,146951,146951,0,1,0.0,-281839.0
2011-05-15,146951,145420,-1531,1,-1531.0,-283370.0
2011-05-16,145420,146441,1021,-1,-1021.0,-284391.0
2011-05-17,146441,144910,-1531,1,-1531.0,-285922.0
2011-05-18,144910,139297,-5613,0,-0.0,-285922.0
2011-05-19,139297,140318,1021,-1,-1021.0,-286943.0
2011-05-20,140318,140318,0,1,0.0,-286943.0
2011-05-21,140318,140318,0,0,0.0,-286943.0
2011-05-22,140318,137766,-2552,-1,2552.0,-284391.0
2011-05-23,137766,134195,-3571,0,-0.0,-284391.0
2011-05-24,134195,130113,-4082,0,-0.0,-284391.0
2011-05-25,130113,132154,2041,1,2041.0,-282350.0
2011-05-26,132154,130113,-2041,1,-2041.0,-284391.0
2011-05-27,130113,130113,0,0,0.0,-284391.0
2011-05-28,130113,130113,0,-1,-0.0,-284391.0
2011-05-29,130113,127051,-3062,-1,3062.0,-281329.0
2011-05-30,127051,124500,-2551,0,-0.0,-281329.0
2011-05-31,124500,127561,3061,0,0.0,-281329.0
2011-06-01,127561,127051,-510,0,-0.0,-281329.0
2011-06-02,127051,128582,1531,1,1531.0,-279798.0
2011-06-03,128582,128582,0,0,0.0,-279798.0
2011-06-04,128582,128582,0,-1,-0.0,-279798.0
2011-06-05,128582,128582,0,0,0.0,-279798.0
2011-06-06,128582,127051,-1531,1,-1531.0,-281329.0
2011-06-07,127051,126541,-510,0,-0.0,-281329.0
2011-06-08,126541,121439,-5102,-1,5102.0,-276227.0
2011-06-09,121439,114805,-6634,1,-6634.0,-282861.0
2011-06-10,114805,114805,0,0,0.0,-282861.0
2011-06-11,114805,114805,0,0,0.0,-282861.0
2011-06-12,114805,106131,-8674,1,-8674.0,-291535.0
2011-06-13,106131,107662,1531,-1,-1531.0,-293066.0
2011-06-14,107662,111234,3572,1,3572.0,-289494.0
2011-06-15,111234,108172,-3062,-1,3062.0,-286432.0
2011-06-16,108172,115316,7144,-1,-7144.0,-293576.0
2011-06-17,115316,115316,0,-1,-0.0,-293576.0
2011-06-18,115316,115316,0,0,0.0,-293576.0
2011-06-19,115316,117867,2551,1,2551.0,-291025.0
2011-06-20,117867,120928,3061,1,3061.0,-287964.0
2011-06-21,120928,118887,-2041,0,-0.0,-287964.0
2011-06-22,118887,122459,3572,1,3572.0,-284392.0
2011-06-23,122459,123480,1021,0,0.0,-284392.0
2011-06-24,123480,123480,0,1,0.0,-284392.0
2011-06-25,123480,123480,0,1,0.0,-284392.0
2011-06-26,123480,124500,1020,0,0.0,-284392.0
2011-06-27,124500,123990,-510,0,-0.0,-284392.0
2011-06-28,123990,126031,2041,1,2041.0,-282351.0
2011-06-29,126031,127561,1530,-1,-1530.0,-283881.0
2011-06-30,127561,130113,2552,0,0.0,-283881.0
2011-07-01,130113,130113,0,0,0.0,-283881.0
2011-07-02,130113,130113,0,0,0.0,-283881.0
2011-07-03,130113,134705,4592,0,0.0,-283881.0
2011-07-04,134705,137256,2551,-1,-2551.0,-286432.0
2011-07-05,137256,138787,1531,1,1531.0,-284901.0
2011-07-06,138787,138277,-510,-1,510.0,-284391.0
2011-07-07,138277,141848,3571,1,3571.0,-280820.0
2011-07-08,141848,141848,0,1,0.0,-280820.0
2011-07-09,141848,141848,0,-1,-0.0,-280820.0
2011-07-10,141848,141848,0,1,0.0,-280820.0
2011-07-11,141848,137766,-4082,-1,4082.0,-276738.0
2011-07-12,137766,139297,1531,1,1531.0,-275207.0
2011-07-13,139297,140828,1531,-1,-1531.0,-276738.0
2011-07-14,140828,145420,4592,0,0.0,-276738.0
2011-07-15,145420,145420,0,1,0.0,-276738.0
2011-07-16,145420,145420,0,1,0.0,-276738.0
2011-07-17,145420,145930,510,0,0.0,-276738.0
2011-07-18,145930,140828,-5102,-1,5102.0,-271636.0
2011-07-19,140828,142869,2041,0,0.0,-271636.0
2011-07-20,142869,139807,-3062,-1,3062.0,-268574.0
2011-07-21,139807,139297,-510,0,-0.0,-268574.0
2011-07-22,139297,139297,0,1,0.0,-268574.0
2011-07-23,139297,139297,0,1,0.0,-268574.0
2011-07-24,139297,142359,3062,-1,-3062.0,-271636.0
2011-07-25,142359,150523,8164,-1,-8164.0,-279800.0
2011-07-26,150523,150523,0,-1,-0.0,-279800.0
2011-07-27,150523,151033,510,-1,-510.0,-280310.0
2011-07-28,151033,151033,0,0,0.0,-280310.0
2011-07-29,151033,151033,0,1,0.0,-280310.0
2011-07-30,151033,151033,0,0,0.0,-280310.0
2011-07-31,151033,152053,1020,1,1020.0,-279290.0
2011-08-01,152053,147971,-4082,1,-4082.0,-283372.0
2011-08-02,147971,142869,-5102,0,-0.0,-283372.0
2011-08-03,142869,141848,-1021,-1,1021.0,-282351.0
2011-08-04,141848,135725,-6123,0,-0.0,-282351.0
2011-08-05,135725,135725,0,1,0.0,-282351.0
2011-08-06,135725,135725,0,-1,-0.0,-282351.0
2011-08-07,135725,131643,-4082,1,-4082.0,-286433.0
2011-08-08,131643,126541,-5102,1,-5102.0,-291535.0
2011-08-09,126541,129602,3061,1,3061.0,-288474.0
2011-08-10,129602,129092,-510,1,-510.0,-288984.0
2011-08-11,129092,128072,-1020,0,-0.0,-288984.0
2011-08-12,128072,128072,0,0,0.0,-288984.0
2011-08-13,128072,128072,0,-1,-0.0,-288984.0
2011-08-14,128072,128072,0,0,0.0,-288984.0
2011-08-15,128072,134195,6123,0,0.0,-288984.0
2011-08-16,134195,137256,3061,1,3061.0,-285923.0
2011-08-17,137256,135725,-1531,-1,1531.0,-284392.0
2011-08-18,135725,125010,-10715,-1,10715.0,-273677.0
2011-08-19,125010,125010,0,-1,-0.0,-273677.0
2011-08-20,125010,125010,0,-1,-0.0,-273677.0
2011-08-21,125010,125010,0,1,0.0,-273677.0
2011-08-22,125010,127051,2041,-1,-2041.0,-275718.0
2011-08-23,127051,123990,-3061,1,-3061.0,-278779.0
2011-08-24,123990,124500,510,1,510.0,-278269.0
2011-08-25,124500,129602,5102,0,0.0,-278269.0
2011-08-26,129602,129602,0,1,0.0,-278269.0
2011-08-27,129602,129602,0,-1,-0.0,-278269.0
2011-08-28,129602,134705,5103,1,5103.0,-273166.0
2011-08-29,134705,137256,2551,0,0.0,-273166.0
2011-08-30,137256,137766,510,-1,-510.0,-273676.0
2011-08-31,137766,140318,2552,0,0.0,-273676.0
2011-09-01,140318,140318,0,-1,-0.0,-273676.0
2011-09-02,140318,140318,0,1,0.0,-273676.0
2011-09-03,140318,140318,0,1,0.0,-273676.0
2011-09-04,140318,136236,-4082,-1,4082.0,-269594.0
2011-09-05,136236,138277,2041,0,0.0,-269594.0
2011-09-06,138277,141848,3571,-1,-3571.0,-273165.0
2011-09-07,141848,141848,0,0,0.0,-273165.0
2011-09-08,141848,137766,-4082,-1,4082.0,-269083.0
2011-09-09,137766,137766,0,1,0.0,-269083.0
2011-09-10,137766,137766,0,1,0.0,-269083.0
2011-09-11,137766,137766,0,0,0.0,-269083.0
2011-09-12,137766,137766,0,-1,-0.0,-269083.0
2011-09-13,137766,127051,-10715,0,-0.0,-269083.0
2011-09-14,127051,130113,3062,0,0.0,-269083.0
2011-09-15,130113,135725,5612,0,0.0,-269083.0
2011-09-16,135725,135725,0,-1,-0.0,-269083.0
2011-09-17,135725,135725,0,0,0.0,-269083.0
2011-09-18,135725,136746,1021,0,0.0,-269083.0
2011-09-19,136746,138277,1531,0,0.0,-269083.0
2011-09-20,138277,141848,3571,1,3571.0,-265512.0
2011-09-21,141848,141848,0,0,0.0,-265512.0
2011-09-22,141848,137766,-4082,0,-0.0,-265512.0
2011-09-23,137766,137766,0,-1,-0.0,-265512.0
2011-09-24,137766,137766,0,-1,-0.0,-265512.0
2011-09-25,137766,133684,-4082,-1,4082.0,-261430.0
2011-09-26,133684,138787,5103,1,5103.0,-256327.0
2011-09-27,138787,139807,1020,-1,-1020.0,-257347.0
2011-09-28,139807,141848,2041,1,2041.0,-255306.0
2011-09-29,141848,138787,-3061,-1,3061.0,-252245.0
2011-09-30,138787,138787,0,-1,-0.0,-252245.0
2011-10-01,138787,138787,0,1,0.0,-252245.0
2011-10-02,138787,138787,0,-1,-0.0,-252245.0
2011-10-03,138787,135725,-3062,-1,3062.0,-249183.0
2011-10-04,135725,132664,-3061,0,-0.0,-249183.0
2011-10-05,132664,135725,3061,0,0.0,-249183.0
2011-10-06,135725,136746,1021,-1,-1021.0,-250204.0
2011-10-07,136746,136746,0,0,0.0,-250204.0
2011-10-08,136746,136746,0,-1,-0.0,-250204.0
2011-10-09,136746,135215,-1531,0,-0.0,-250204.0
2011-10-10,135215,134195,-1020,1,-1020.0,-251224.0
2011-10-11,134195,131643,-2552,-1,2552.0,-248672.0
2011-10-12,131643,129092,-2551,1,-2551.0,-251223.0
2011-10-13,129092,131133,2041,1,2041.0,-249182.0
2011-10-14,131133,131133,0,0,0.0,-249182.0
2011-10-15,131133,131133,0,1,0.0,-249182.0
2011-10-16,131133,131133,0,-1,-0.0,-249182.0
2011-10-17,131133,132154,1021,0,0.0,-249182.0
2011-10-18,132154,134705,2551,-1,-2551.0,-251733.0
2011-10-19,134705,129602,-5103,1,-5103.0,-256836.0
2011-10-20,129602,135725,6123,0,0.0,-256836.0
2011-10-21,135725,135725,0,-1,-0.0,-256836.0
2011-10-22,135725,135725,0,-1,-0.0,-256836.0
2011-10-23,135725,148992,13267,-1,-13267.0,-270103.0
2011-10-24,148992,150012,1020,-1,-1020.0,-271123.0
2011-10-25,150012,151033,1021,1,1021.0,-270102.0
2011-10-26,151033,152053,1020,1,1020.0,-269082.0
2011-10-27,152053,147971,-4082,0,-0.0,-269082.0
2011-10-28,147971,147971,0,1,0.0,-269082.0
2011-10-29,147971,147971,0,-1,-0.0,-269082.0
2011-10-30,147971,145420,-2551,1,-2551.0,-271633.0
2011-10-31,145420,144400,-1020,1,-1020.0,-272653.0
2011-11-01,144400,146951,2551,1,2551.0,-270102.0
2011-11-02,146951,150012,3061,0,0.0,-270102.0
2011-11-03,150012,151033,1021,0,0.0,-270102.0
2011-11-04,151033,151033,0,1,0.0,-270102.0
2011-11-05,151033,151033,0,-1,-0.0,-270102.0
2011-11-06,151033,151543,510,0,0.0,-270102.0
2011-11-07,151543,151033,-510,1,-510.0,-270612.0
2011-11-08,151033,146951,-4082,0,-0.0,-270612.0
2011-11-09,146951,136236,-10715,1,-10715.0,-281327.0
2011-11-10,136236,139807,3571,0,0.0,-281327.0
2011-11-11,139807,139807,0,1,0.0,-281327.0
2011-11-12,139807,139807,0,1,0.0,-281327.0
2011-11-13,139807,153074,13267,0,0.0,-281327.0
2011-11-14,153074,153074,0,0,0.0,-281327.0
2011-11-15,153074,151033,-2041,1,-2041.0,-283368.0
2011-11-16,151033,154605,3572,1,3572.0,-279796.0
2011-11-17,154605,151543,-3062,0,-0.0,-279796.0
2011-11-18,151543,151543,0,1,0.0,-279796.0
2011-11-19,151543,151543,0,1,0.0,-279796.0
2011-11-20,151543,150012,-1531,1,-1531.0,-281327.0
2011-11-21,150012,147971,-2041,-1,2041.0,-279286.0
2011-11-22,147971,142359,-5612,0,-0.0,-279286.0
2011-11-23,142359,145420,3061,0,0.0,-279286.0
2011-11-24,145420,140318,-5102,1,-5102.0,-284388.0
2011-11-25,140318,140318,0,-1,-0.0,-284388.0
2011-11-26,140318,140318,0,0,0.0,-284388.0
2011-11-27,140318,140828,510,0,0.0,-284388.0
2011-11-28,140828,144910,4082,0,0.0,-284388.0
2011-11-29,144910,142869,-2041,1,-2041.0,-286429.0
2011-11-30,142869,148482,5613,0,0.0,-286429.0
2011-12-01,148482,154605,6123,-1,-6123.0,-292552.0
2011-12-02,154605,154605,0,0,0.0,-292552.0
2011-12-03,154605,154605,0,-1,-0.0,-292552.0
2011-12-04,154605,155625,1020,0,0.0,-292552.0
2011-12-05,155625,156135,510,1,510.0,-292042.0
2011-12-06,156135,156645,510,0,0.0,-292042.0
2011-12-07,156645,152053,-4592,-1,4592.0,-287450.0
2011-12-08,152053,148992,-3061,-1,3061.0,-284389.0
2011-12-09,148992,148992,0,-1,-0.0,-284389.0
2011-12-10,148992,148992,0,1,0.0,-284389.0
2011-12-11,148992,152053,3061,1,3061.0,-281328.0
2011-12-12,152053,153584,1531,-1,-1531.0,-282859.0
2011-12-13,153584,153074,-510,0,-0.0,-282859.0
2011-12-14,153074,151033,-2041,1,-2041.0,-284900.0
2011-12-15,151033,151033,0,-1,-0.0,-284900.0
2011-12-16,151033,151033,0,1,0.0,-284900.0
2011-12-17,151033,151033,0,-1,-0.0,-284900.0
2011-12-18,151033,146951,-4082,1,-4082.0,-288982.0
2011-12-19,146951,145930,-1021,1,-1021.0,-290003.0
2011-12-20,145930,147971,2041,-1,-2041.0,-292044.0
2011-12-21,147971,148992,1021,1,1021.0,-291023.0
2011-12-22,148992,149502,510,1,510.0,-290513.0
2011-12-23,149502,149502,0,1,0.0,-290513.0
2011-12-24,149502,149502,0,-1,-0.0,-290513.0
2011-12-25,149502,147971,-1531,0,-0.0,-290513.0
2011-12-26,147971,145930,-2041,-1,2041.0,-288472.0
2011-12-27,145930,144910,-1020,0,-0.0,-288472.0
2011-12-28,144910,145930,1020,1,1020.0,-287452.0
2011-12-29,145930,145930,0,-1,-0.0,-287452.0
2011-12-30,145930,145930,0,-1,-0.0,-287452.0
2011-12-31,145930,145930,0,0,0.0,-287452.0
2012-01-01,145930,146441,511,1,511.0,-286941.0
2012-01-02,146441,147971,1530,1,1530.0,-285411.0
2012-01-03,147971,146441,-1530,1,-1530.0,-286941.0
2012-01-04,146441,147971,1530,-1,-1530.0,-288471.0
2012-01-05,147971,144400,-3571,1,-3571.0,-292042.0
2012-01-06,144400,144400,0,1,0.0,-292042.0
2012-01-07,144400,144400,0,1,0.0,-292042.0
2012-01-08,144400,146441,2041,0,0.0,-292042.0
2012-01-09,146441,145420,-1021,0,-0.0,-292042.0
2012-01-10,145420,146951,1531,1,1531.0,-290511.0
2012-01-11,146951,148992,2041,0,0.0,-290511.0
2012-01-12,148992,150523,1531,-1,-1531.0,-292042.0
2012-01-13,150523,150523,0,-1,-0.0,-292042.0
2012-01-14,150523,150523,0,1,0.0,-292042.0
2012-01-15,150523,147461,-3062,0,-0.0,-292042.0
2012-01-16,147461,150012,2551,1,2551.0,-289491.0
2012-01-17,150012,152053,2041,-1,-2041.0,-291532.0
2012-01-18,152053,153074,1021,1,1021.0,-290511.0
2012-01-19,153074,153074,0,-1,-0.0,-290511.0
2012-01-20,153074,153074,0,-1,-0.0,-290511.0
2012-01-21,153074,153074,0,0,0.0,-290511.0
2012-01-22,153074,153074,0,0,0.0,-290511.0
2012-01-23,153074,153074,0,0,0.0,-290511.0
2012-01-24,153074,154605,1531,0,0.0,-290511.0
2012-01-25,154605,155115,510,-1,-510.0,-291021.0
2012-01-26,155115,153584,-1531,-1,1531.0,-289490.0
2012-01-27,153584,153584,0,1,0.0,-289490.0
2012-01-28,153584,153584,0,1,0.0,-289490.0
2012-01-29,153584,153074,-510,0,-0.0,-289490.0
2012-01-30,153074,156135,3061,-1,-3061.0,-292551.0
2012-01-31,156135,157156,1021,0,0.0,-292551.0
2012-02-01,157156,164809,7653,1,7653.0,-284898.0
2012-02-02,164809,167361,2552,0,0.0,-284898.0
2012-02-03,167361,167361,0,-1,-0.0,-284898.0
2012-02-04,167361,167361,0,1,0.0,-284898.0
2012-02-05,167361,168891,1530,1,1530.0,-283368.0
2012-02-06,168891,168381,-510,-1,510.0,-282858.0
2012-02-07,168381,168381,0,-1,-0.0,-282858.0
2012-02-08,168381,170932,2551,-1,-2551.0,-285409.0
2012-02-09,170932,167871,-3061,1,-3061.0,-288470.0
2012-02-10,167871,167871,0,0,0.0,-288470.0
2012-02-11,167871,167871,0,1,0.0,-288470.0
2012-02-12,167871,165320,-2551,0,-0.0,-288470.0
2012-02-13,165320,168381,3061,-1,-3061.0,-291531.0
2012-02-14,168381,170422,2041,1,2041.0,-289490.0
2012-02-15,170422,166340,-4082,1,-4082.0,-293572.0
2012-02-16,166340,165830,-510,1,-510.0,-294082.0
2012-02-17,165830,165830,0,-1,-0.0,-294082.0
2012-02-18,165830,165830,0,0,0.0,-294082.0
2012-02-19,165830,167871,2041,1,2041.0,-292041.0
2012-02-20,167871,171953,4082,0,0.0,-292041.0
2012-02-21,171953,170422,-1531,-1,1531.0,-290510.0
2012-02-22,170422,168381,-2041,0,-0.0,-290510.0
2012-02-23,168381,171443,3062,0,0.0,-290510.0
2012-02-24,171443,171443,0,1,0.0,-290510.0
2012-02-25,171443,171443,0,0,0.0,-290510.0
2012-02-26,171443,170932,-511,1,-511.0,-291021.0
2012-02-27,170932,171443,511,1,511.0,-290510.0
2012-02-28,171443,175014,3571,0,0.0,-290510.0
2012-02-29,175014,175014,0,0,0.0,-290510.0
2012-03-01,175014,175014,0,0,0.0,-290510.0
2012-03-02,175014,175014,0,1,0.0,-290510.0
2012-03-03,175014,175014,0,0,0.0,-290510.0
2012-03-04,175014,173484,-1530,1,-1530.0,-292040.0
2012-03-05,173484,171443,-2041,-1,2041.0,-289999.0
2012-03-06,171443,169402,-2041,-1,2041.0,-287958.0
2012-03-07,169402,170422,1020,0,0.0,-287958.0
2012-03-08,170422,170422,0,-1,-0.0,-287958.0
2012-03-09,170422,170422,0,-1,-0.0,-287958.0
2012-03-10,170422,170422,0,-1,-0.0,-287958.0
2012-03-11,170422,165320,-5102,0,-0.0,-287958.0
2012-03-12,165320,159197,-6123,1,-6123.0,-294081.0
2012-03-13,159197,157156,-2041,-1,2041.0,-292040.0
2012-03-14,157156,160217,3061,0,0.0,-292040.0
2012-03-15,160217,159707,-510,-1,510.0,-291530.0
2012-03-16,159707,159707,0,-1,-0.0,-291530.0
2012-03-17,159707,159707,0,1,0.0,-291530.0
2012-03-18,159707,161748,2041,-1,-2041.0,-293571.0
2012-03-19,161748,156645,-5103,0,-0.0,-293571.0
2012-03-20,156645,155115,-1530,1,-1530.0,-295101.0
2012-03-21,155115,150012,-5103,-1,5103.0,-289998.0
2012-03-22,150012,151033,1021,-1,-1021.0,-291019.0
2012-03-23,151033,151033,0,-1,-0.0,-291019.0
2012-03-24,151033,151033,0,1,0.0,-291019.0
2012-03-25,151033,149502,-1531,1,-1531.0,-292550.0
2012-03-26,149502,154094,4592,0,0.0,-292550.0
2012-03-27,154094,153074,-1020,0,-0.0,-292550.0
2012-03-28,153074,152053,-1021,1,-1021.0,-293571.0
2012-03-29,152053,154094,2041,1,2041.0,-291530.0
2012-03-30,154094,154094,0,0,0.0,-291530.0
2012-03-31,154094,154094,0,-1,-0.0,-291530.0
2012-04-01,154094,154094,0,-1,-0.0,-291530.0
2012-04-02,154094,150012,-4082,-1,4082.0,-287448.0
2012-04-03,150012,146441,-3571,-1,3571.0,-283877.0
2012-04-04,146441,144910,-1531,1,-1531.0,-285408.0
2012-04-05,144910,147971,3061,-1,-3061.0,-288469.0
2012-04-06,147971,147971,0,1,0.0,-288469.0
2012-04-07,147971,147971,0,0,0.0,-288469.0
2012-04-08,147971,140828,-7143,1,-7143.0,-295612.0
2012-04-09,140828,141338,510,1,510.0,-295102.0
2012-04-10,141338,141338,0,-1,-0.0,-295102.0
2012-04-11,141338,144910,3572,-1,-3572.0,-298674.0
2012-04-12,144910,145930,1020,1,1020.0,-297654.0
2012-04-13,145930,145930,0,1,0.0,-297654.0
2012-04-14,145930,145930,0,1,0.0,-297654.0
2012-04-15,145930,145930,0,0,0.0,-297654.0
2012-04-16,145930,146441,511,0,0.0,-297654.0
2012-04-17,146441,147971,1530,0,0.0,-297654.0
2012-04-18,147971,146441,-1530,0,-0.0,-297654.0
2012-04-19,146441,144400,-2041,1,-2041.0,-299695.0
2012-04-20,144400,144400,0,0,0.0,-299695.0
2012-04-21,144400,144400,0,1,0.0,-299695.0
2012-04-22,144400,141848,-2552,1,-2552.0,-302247.0
2012-04-23,141848,138787,-3061,-1,3061.0,-299186.0
2012-04-24,138787,138787,0,1,0.0,-299186.0
2012-04-25,138787,137256,-1531,1,-1531.0,-300717.0
2012-04-26,137256,139807,2551,1,2551.0,-298166.0
2012-04-27,139807,139807,0,-1,-0.0,-298166.0
2012-04-28,139807,139807,0,0,0.0,-298166.0
2012-04-29,139807,140828,1021,0,0.0,-298166.0
2012-04-30,140828,140828,0,-1,-0.0,-298166.0
2012-05-01,140828,143889,3061,1,3061.0,-295105.0
2012-05-02,143889,143889,0,0,0.0,-295105.0
2012-05-03,143889,145930,2041,1,2041.0,-293064.0
2012-05-04,145930,145930,0,1,0.0,-293064.0
2012-05-05,145930,145930,0,0,0.0,-293064.0
2012-05-06,145930,144910,-1020,0,-0.0,-293064.0
2012-05-07,144910,142869,-2041,1,-2041.0,-295105.0
2012-05-08,142869,137766,-5103,-1,5103.0,-290002.0
2012-05-09,137766,135725,-2041,-1,2041.0,-287961.0
2012-05-10,135725,129602,-6123,-1,6123.0,-281838.0
2012-05-11,129602,129602,0,1,0.0,-281838.0
2012-05-12,129602,129602,0,1,0.0,-281838.0
2012-05-13,129602,130113,511,0,0.0,-281838.0
2012-05-14,130113,127051,-3062,1,-3062.0,-284900.0
2012-05-15,127051,123480,-3571,-1,3571.0,-281329.0
2012-05-16,123480,126031,2551,-1,-2551.0,-283880.0
2012-05-17,126031,122969,-3062,1,-3062.0,-286942.0
2012-05-18,122969,122969,0,1,0.0,-286942.0
2012-05-19,122969,122969,0,0,0.0,-286942.0
2012-05-20,122969,121949,-1020,1,-1020.0,-287962.0
2012-05-21,121949,123990,2041,-1,-2041.0,-290003.0
2012-05-22,123990,123480,-510,-1,510.0,-289493.0
2012-05-23,123480,130623,7143,-1,-7143.0,-296636.0
2012-05-24,130623,133684,3061,0,0.0,-296636.0
2012-05-25,133684,133684,0,0,0.0,-296636.0
2012-05-26,133684,133684,0,-1,-0.0,-296636.0
2012-05-27,133684,133684,0,1,0.0,-296636.0
2012-05-28,133684,133174,-510,-1,510.0,-296126.0
2012-05-29,133174,131643,-1531,0,-0.0,-296126.0
2012-05-30,131643,127561,-4082,-1,4082.0,-292044.0
2012-05-31,127561,123990,-3571,0,-0.0,-292044.0
2012-06-01,123990,123990,0,0,0.0,-292044.0
2012-06-02,123990,123990,0,1,0.0,-292044.0
2012-06-03,123990,122459,-1531,0,-0.0,-292044.0
2012-06-04,122459,123990,1531,-1,-1531.0,-293575.0
2012-06-05,123990,123990,0,-1,-0.0,-293575.0
2012-06-06,123990,127561,3571,-1,-3571.0,-297146.0
2012-06-07,127561,127561,0,-1,-0.0,-297146.0
2012-06-08,127561,127561,0,0,0.0,-297146.0
2012-06-09,127561,127561,0,-1,-0.0,-297146.0
2012-06-10,127561,130113,2552,-1,-2552.0,-299698.0
2012-06-11,130113,130113,0,1,0.0,-299698.0
2012-06-12,130113,132154,2041,0,0.0,-299698.0
2012-06-13,132154,129602,-2552,0,-0.0,-299698.0
2012-06-14,129602,127561,-2041,-1,2041.0,-297657.0
2012-06-15,127561,127561,0,1,0.0,-297657.0
2012-06-16,127561,127561,0,0,0.0,-297657.0
2012-06-17,127561,129602,2041,0,0.0,-297657.0
2012-06-18,129602,128582,-1020,1,-1020.0,-298677.0
2012-06-19,128582,134705,6123,0,0.0,-298677.0
2012-06-20,134705,132664,-2041,-1,2041.0,-296636.0
2012-06-21,132664,132664,0,0,0.0,-296636.0
