date,price,next_price,diff_price,action,reward,cumulated_reward
2012-06-22,132154,132154,0,1,0.0,0.0
2012-06-23,132154,132154,0,1,0.0,0.0
2012-06-24,132154,130623,-1531,1,-1531.0,-1531.0
2012-06-25,130623,131643,1020,1,1020.0,-511.0
2012-06-26,131643,131643,0,1,0.0,-511.0
2012-06-27,131643,133684,2041,1,2041.0,1530.0
2012-06-28,133684,132154,-1530,1,-1530.0,0.0
2012-06-29,132154,132154,0,1,0.0,0.0
2012-06-30,132154,132154,0,1,0.0,0.0
2012-07-01,132154,137256,5102,1,5102.0,5102.0
2012-07-02,137256,137766,510,1,510.0,5612.0
2012-07-03,137766,138787,1021,1,1021.0,6633.0
2012-07-04,138787,137766,-1021,1,-1021.0,5612.0
2012-07-05,137766,138787,1021,1,1021.0,6633.0
2012-07-06,138787,138787,0,1,0.0,6633.0
2012-07-07,138787,138787,0,1,0.0,6633.0
2012-07-08,138787,137256,-1531,1,-1531.0,5102.0
2012-07-09,137256,137256,0,1,0.0,5102.0
2012-07-10,137256,133174,-4082,1,-4082.0,1020.0
2012-07-11,133174,128582,-4592,1,-4592.0,-3572.0
2012-07-12,128582,133174,4592,1,4592.0,1020.0
2012-07-13,133174,133174,0,1,0.0,1020.0
2012-07-14,133174,133174,0,1,0.0,1020.0
2012-07-15,133174,133684,510,1,510.0,1530.0
2012-07-16,133684,130623,-3061,1,-3061.0,-1531.0
2012-07-17,130623,127051,-3572,1,-3572.0,-5103.0
2012-07-18,127051,129092,2041,1,2041.0,-3062.0
2012-07-19,129092,129602,510,1,510.0,-2552.0
2012-07-20,129602,129602,0,1,0.0,-2552.0
2012-07-21,129602,129602,0,1,0.0,-2552.0
2012-07-22,129602,125010,-4592,1,-4592.0,-7144.0
2012-07-23,125010,125520,510,1,510.0,-6634.0
2012-07-24,125520,123990,-1530,1,-1530.0,-8164.0
2012-07-25,123990,129092,5102,1,5102.0,-3062.0
2012-07-26,129092,131133,2041,1,2041.0,-1021.0
2012-07-27,131133,131133,0,1,0.0,-1021.0
2012-07-28,131133,131133,0,1,0.0,-1021.0
2012-07-29,131133,133684,2551,1,2551.0,1530.0
2012-07-30,133684,135215,1531,1,1531.0,3061.0
2012-07-31,135215,133684,-1531,1,-1531.0,1530.0
2012-08-01,133684,137766,4082,1,4082.0,5612.0
2012-08-02,137766,136236,-1530,1,-1530.0,4082.0
2012-08-03,136236,136236,0,1,0.0,4082.0
2012-08-04,136236,136236,0,1,0.0,4082.0
2012-08-05,136236,139807,3571,1,3571.0,7653.0
2012-08-06,139807,141338,1531,1,1531.0,9184.0
2012-08-07,141338,138277,-3061,1,-3061.0,6123.0
2012-08-08,138277,138787,510,1,510.0,6633.0
2012-08-09,138787,140318,1531,1,1531.0,8164.0
2012-08-10,140318,140318,0,1,0.0,8164.0
2012-08-11,140318,140318,0,1,0.0,8164.0
2012-08-12,140318,138277,-2041,1,-2041.0,6123.0
2012-08-13,138277,139807,1530,1,1530.0,7653.0
2012-08-14,139807,139807,0,1,0.0,7653.0
2012-08-15,139807,138277,-1530,1,-1530.0,6123.0
2012-08-16,138277,138787,510,1,510.0,6633.0
2012-08-17,138787,138787,0,1,0.0,6633.0
2012-08-18,138787,138787,0,1,0.0,6633.0
2012-08-19,138787,142359,3572,1,3572.0,10205.0
2012-08-20,142359,143889,1530,1,1530.0,11735.0
2012-08-21,143889,141848,-2041,1,-2041.0,9694.0
2012-08-22,141848,139297,-2551,1,-2551.0,7143.0
2012-08-23,139297,137766,-1531,1,-1531.0,5612.0
2012-08-24,137766,137766,0,1,0.0,5612.0
2012-08-25,137766,137766,0,1,0.0,5612.0
2012-08-26,137766,137766,0,1,0.0,5612.0
2012-08-27,137766,137766,0,1,0.0,5612.0
2012-08-28,137766,139297,1531,1,1531.0,7143.0
2012-08-29,139297,135215,-4082,1,-4082.0,3061.0
2012-08-30,135215,138277,3062,1,3062.0,6123.0
2012-08-31,138277,138277,0,1,0.0,6123.0
2012-09-01,138277,138277,0,1,0.0,6123.0
2012-09-02,138277,138787,510,1,510.0,6633.0
2012-09-03,138787,140828,2041,1,2041.0,8674.0
2012-09-04,140828,137256,-3572,1,-3572.0,5102.0
2012-09-05,137256,137256,0,1,0.0,5102.0
2012-09-06,137256,141338,4082,1,4082.0,9184.0
2012-09-07,141338,141338,0,1,0.0,9184.0
2012-09-08,141338,141338,0,1,0.0,9184.0
2012-09-09,141338,141338,0,1,0.0,9184.0
2012-09-10,141338,138277,-3061,1,-3061.0,6123.0
2012-09-11,138277,139297,1020,1,1020.0,7143.0
2012-09-12,139297,139807,510,1,510.0,7653.0
2012-09-13,139807,147971,8164,1,8164.0,15817.0
2012-09-14,147971,147971,0,1,0.0,15817.0
2012-09-15,147971,147971,0,1,0.0,15817.0
2012-09-16,147971,150523,2552,1,2552.0,18369.0
2012-09-17,150523,147461,-3062,1,-3062.0,15307.0
2012-09-18,147461,144400,-3061,1,-3061.0,12246.0
2012-09-19,144400,142359,-2041,1,-2041.0,10205.0
2012-09-20,142359,142359,0,1,0.0,10205.0
2012-09-21,142359,142359,0,1,0.0,10205.0
2012-09-22,142359,142359,0,1,0.0,10205.0
2012-09-23,142359,141848,-511,1,-511.0,9694.0
2012-09-24,141848,142359,511,1,511.0,10205.0
2012-09-25,142359,141848,-511,1,-511.0,9694.0
2012-09-26,141848,139807,-2041,1,-2041.0,7653.0
2012-09-27,139807,140318,511,1,511.0,8164.0
2012-09-28,140318,140318,0,1,0.0,8164.0
2012-09-29,140318,140318,0,1,0.0,8164.0
2012-09-30,140318,140318,0,1,0.0,8164.0
2012-10-01,140318,138787,-1531,1,-1531.0,6633.0
2012-10-02,138787,138787,0,1,0.0,6633.0
2012-10-03,138787,140828,2041,1,2041.0,8674.0
2012-10-04,140828,141338,510,1,510.0,9184.0
2012-10-05,141338,141338,0,1,0.0,9184.0
2012-10-06,141338,141338,0,1,0.0,9184.0
2012-10-07,141338,141848,510,1,510.0,9694.0
2012-10-08,141848,136746,-5102,1,-5102.0,4592.0
2012-10-09,136746,132664,-4082,1,-4082.0,510.0
2012-10-10,132664,128582,-4082,1,-4082.0,-3572.0
2012-10-11,128582,130113,1531,1,1531.0,-2041.0
2012-10-12,130113,130113,0,1,0.0,-2041.0
2012-10-13,130113,130113,0,1,0.0,-2041.0
2012-10-14,130113,128072,-2041,1,-2041.0,-4082.0
2012-10-15,128072,132154,4082,1,4082.0,0.0
2012-10-16,132154,133174,1020,1,1020.0,1020.0
2012-10-17,133174,132154,-1020,1,-1020.0,0.0
2012-10-18,132154,134705,2551,1,2551.0,2551.0
2012-10-19,134705,134705,0,1,0.0,2551.0
2012-10-20,134705,134705,0,1,0.0,2551.0
2012-10-21,134705,134705,0,1,0.0,2551.0
2012-10-22,134705,135725,1020,1,1020.0,3571.0
2012-10-23,135725,132664,-3061,1,-3061.0,510.0
2012-10-24,132664,132154,-510,1,-510.0,0.0
2012-10-25,132154,127561,-4593,1,-4593.0,-4593.0
2012-10-26,127561,127561,0,1,0.0,-4593.0
2012-10-27,127561,127561,0,1,0.0,-4593.0
2012-10-28,127561,128582,1021,1,1021.0,-3572.0
2012-10-29,128582,128582,0,1,0.0,-3572.0
2012-10-30,128582,128582,0,1,0.0,-3572.0
2012-10-31,128582,125520,-3062,1,-3062.0,-6634.0
2012-11-01,125520,128072,2552,1,2552.0,-4082.0
2012-11-02,128072,128072,0,1,0.0,-4082.0
2012-11-03,128072,128072,0,1,0.0,-4082.0
2012-11-04,128072,129602,1530,1,1530.0,-2552.0
2012-11-05,129602,130113,511,1,511.0,-2041.0
2012-11-06,130113,131133,1020,1,1020.0,-1021.0
2012-11-07,131133,129602,-1531,1,-1531.0,-2552.0
2012-11-08,129602,127561,-2041,1,-2041.0,-4593.0
2012-11-09,127561,127561,0,1,0.0,-4593.0
2012-11-10,127561,127561,0,1,0.0,-4593.0
2012-11-11,127561,125520,-2041,1,-2041.0,-6634.0
2012-11-12,125520,123990,-1530,1,-1530.0,-8164.0
2012-11-13,123990,125010,1020,1,1020.0,-7144.0
2012-11-14,125010,125520,510,1,510.0,-6634.0
2012-11-15,125520,124500,-1020,1,-1020.0,-7654.0
2012-11-16,124500,124500,0,1,0.0,-7654.0
2012-11-17,124500,124500,0,1,0.0,-7654.0
2012-11-18,124500,126541,2041,1,2041.0,-5613.0
2012-11-19,126541,127051,510,1,510.0,-5103.0
2012-11-20,127051,123990,-3061,1,-3061.0,-8164.0
2012-11-21,123990,124500,510,1,510.0,-7654.0
2012-11-22,124500,125520,1020,1,1020.0,-6634.0
2012-11-23,125520,125520,0,1,0.0,-6634.0
2012-11-24,125520,125520,0,1,0.0,-6634.0
2012-11-25,125520,126541,1021,1,1021.0,-5613.0
2012-11-26,126541,128072,1531,1,1531.0,-4082.0
2012-11-27,128072,127561,-511,1,-511.0,-4593.0
2012-11-28,127561,130113,2552,1,2552.0,-2041.0
2012-11-29,130113,129092,-1021,1,-1021.0,-3062.0
2012-11-30,129092,129092,0,1,0.0,-3062.0
2012-12-01,129092,129092,0,1,0.0,-3062.0
2012-12-02,129092,131133,2041,1,2041.0,-1021.0
2012-12-03,131133,130623,-510,1,-510.0,-1531.0
2012-12-04,130623,131133,510,1,510.0,-1021.0
2012-12-05,131133,131643,510,1,510.0,-511.0
2012-12-06,131643,131133,-510,1,-510.0,-1021.0
2012-12-07,131133,131133,0,1,0.0,-1021.0
2012-12-08,131133,131133,0,1,0.0,-1021.0
2012-12-09,131133,131643,510,1,510.0,-511.0
2012-12-10,131643,133174,1531,1,1531.0,1020.0
2012-12-11,133174,133174,0,1,0.0,1020.0
2012-12-12,133174,134195,1021,1,1021.0,2041.0
2012-12-13,134195,133174,-1021,1,-1021.0,1020.0
2012-12-14,133174,133174,0,1,0.0,1020.0
2012-12-15,133174,133174,0,1,0.0,1020.0
2012-12-16,133174,132664,-510,1,-510.0,510.0
2012-12-17,132664,125520,-7144,1,-7144.0,-6634.0
2012-12-18,125520,125520,0,1,0.0,-6634.0
2012-12-19,125520,125520,0,1,0.0,-6634.0
2012-12-20,125520,125010,-510,1,-510.0,-7144.0
2012-12-21,125010,125010,0,1,0.0,-7144.0
2012-12-22,125010,125010,0,1,0.0,-7144.0
2012-12-23,125010,121439,-3571,1,-3571.0,-10715.0
2012-12-24,121439,121439,0,1,0.0,-10715.0
2012-12-25,121439,124500,3061,1,3061.0,-7654.0
2012-12-26,124500,129000,4500,1,4500.0,-3154.0
2012-12-27,129000,129000,0,1,0.0,-3154.0
2012-12-28,129000,129000,0,1,0.0,-3154.0
2012-12-29,129000,129000,0,1,0.0,-3154.0
2012-12-30,129000,129000,0,1,0.0,-3154.0
2012-12-31,129000,129000,0,1,0.0,-3154.0
2013-01-01,129000,131500,2500,1,2500.0,-654.0
2013-01-02,131500,132500,1000,1,1000.0,346.0
2013-01-03,132500,132500,0,1,0.0,346.0
2013-01-04,132500,132500,0,1,0.0,346.0
2013-01-05,132500,132500,0,1,0.0,346.0
2013-01-06,132500,132500,0,1,0.0,346.0
2013-01-07,132500,132000,-500,1,-500.0,-154.0
2013-01-08,132000,132000,0,1,0.0,-154.0
2013-01-09,132000,133500,1500,1,1500.0,1346.0
2013-01-10,133500,132500,-1000,1,-1000.0,346.0
2013-01-11,132500,132500,0,1,0.0,346.0
2013-01-12,132500,132500,0,1,0.0,346.0
2013-01-13,132500,133500,1000,1,1000.0,1346.0
2013-01-14,133500,129000,-4500,1,-4500.0,-3154.0
2013-01-15,129000,129500,500,1,500.0,-2654.0
2013-01-16,129500,128500,-1000,1,-1000.0,-3654.0
2013-01-17,128500,129000,500,1,500.0,-3154.0
2013-01-18,129000,129000,0,1,0.0,-3154.0
2013-01-19,129000,129000,0,1,0.0,-3154.0
2013-01-20,129000,130000,1000,1,1000.0,-2154.0
2013-01-21,130000,130000,0,1,0.0,-2154.0
2013-01-22,130000,129000,-1000,1,-1000.0,-3154.0
2013-01-23,129000,129500,500,1,500.0,-2654.0
2013-01-24,129500,129000,-500,1,-500.0,-3154.0
2013-01-25,129000,129000,0,1,0.0,-3154.0
2013-01-26,129000,129000,0,1,0.0,-3154.0
2013-01-27,129000,128000,-1000,1,-1000.0,-4154.0
2013-01-28,128000,128500,500,1,500.0,-3654.0
2013-01-29,128500,129500,1000,1,1000.0,-2654.0
2013-01-30,129500,128500,-1000,1,-1000.0,-3654.0
2013-01-31,128500,123500,-5000,1,-5000.0,-8654.0
2013-02-01,123500,123500,0,1,0.0,-8654.0
2013-02-02,123500,123500,0,1,0.0,-8654.0
2013-02-03,123500,123500,0,1,0.0,-8654.0
2013-02-04,123500,124500,1000,1,1000.0,-7654.0
2013-02-05,124500,125000,500,1,500.0,-7154.0
2013-02-06,125000,124000,-1000,1,-1000.0,-8154.0
2013-02-07,124000,124500,500,1,500.0,-7654.0
2013-02-08,124500,124500,0,1,0.0,-7654.0
2013-02-09,124500,124500,0,1,0.0,-7654.0
2013-02-10,124500,124500,0,1,0.0,-7654.0
2013-02-11,124500,125000,500,1,500.0,-7154.0
2013-02-12,125000,125500,500,1,500.0,-6654.0
2013-02-13,125500,125000,-500,1,-500.0,-7154.0
2013-02-14,125000,125000,0,1,0.0,-7154.0
2013-02-15,125000,125000,0,1,0.0,-7154.0
2013-02-16,125000,125000,0,1,0.0,-7154.0
2013-02-17,125000,124500,-500,1,-500.0,-7654.0
2013-02-18,124500,125500,1000,1,1000.0,-6654.0
2013-02-19,125500,128000,2500,1,2500.0,-4154.0
2013-02-20,128000,129000,1000,1,1000.0,-3154.0
2013-02-21,129000,128000,-1000,1,-1000.0,-4154.0
2013-02-22,128000,128000,0,1,0.0,-4154.0
2013-02-23,128000,128000,0,1,0.0,-4154.0
2013-02-24,128000,128000,0,1,0.0,-4154.0
2013-02-25,128000,127500,-500,1,-500.0,-4654.0
2013-02-26,127500,128500,1000,1,1000.0,-3654.0
2013-02-27,128500,129000,500,1,500.0,-3154.0
2013-02-28,129000,129000,0,1,0.0,-3154.0
2013-03-01,129000,129000,0,1,0.0,-3154.0
2013-03-02,129000,129000,0,1,0.0,-3154.0
2013-03-03,129000,129000,0,1,0.0,-3154.0
2013-03-04,129000,129500,500,1,500.0,-2654.0
2013-03-05,129500,130500,1000,1,1000.0,-1654.0
2013-03-06,130500,130000,-500,1,-500.0,-2154.0
2013-03-07,130000,131000,1000,1,1000.0,-1154.0
2013-03-08,131000,131000,0,1,0.0,-1154.0
2013-03-09,131000,131000,0,1,0.0,-1154.0
2013-03-10,131000,130000,-1000,1,-1000.0,-2154.0
2013-03-11,130000,129500,-500,1,-500.0,-2654.0
2013-03-12,129500,129000,-500,1,-500.0,-3154.0
2013-03-13,129000,130000,1000,1,1000.0,-2154.0
2013-03-14,130000,128500,-1500,1,-1500.0,-3654.0
2013-03-15,128500,128500,0,1,0.0,-3654.0
2013-03-16,128500,128500,0,1,0.0,-3654.0
2013-03-17,128500,128500,0,1,0.0,-3654.0
2013-03-18,128500,128500,0,1,0.0,-3654.0
2013-03-19,128500,127500,-1000,1,-1000.0,-4654.0
2013-03-20,127500,127000,-500,1,-500.0,-5154.0
2013-03-21,127000,126000,-1000,1,-1000.0,-6154.0
2013-03-22,126000,126000,0,1,0.0,-6154.0
2013-03-23,126000,126000,0,1,0.0,-6154.0
2013-03-24,126000,127500,1500,1,1500.0,-4654.0
2013-03-25,127500,126500,-1000,1,-1000.0,-5654.0
2013-03-26,126500,128500,2000,1,2000.0,-3654.0
2013-03-27,128500,128000,-500,1,-500.0,-4154.0
2013-03-28,128000,129500,1500,1,1500.0,-2654.0
2013-03-29,129500,129500,0,1,0.0,-2654.0
2013-03-30,129500,129500,0,1,0.0,-2654.0
2013-03-31,129500,131000,1500,1,1500.0,-1154.0
2013-04-01,131000,131000,0,1,0.0,-1154.0
2013-04-02,131000,131000,0,1,0.0,-1154.0
2013-04-03,131000,129000,-2000,1,-2000.0,-3154.0
2013-04-04,129000,127000,-2000,1,-2000.0,-5154.0
2013-04-05,127000,127000,0,1,0.0,-5154.0
2013-04-06,127000,127000,0,1,0.0,-5154.0
2013-04-07,127000,127000,0,1,0.0,-5154.0
2013-04-08,127000,126500,-500,1,-500.0,-5654.0
2013-04-09,126500,128000,1500,1,1500.0,-4154.0
2013-04-10,128000,128500,500,1,500.0,-3654.0
2013-04-11,128500,127000,-1500,1,-1500.0,-5154.0
2013-04-12,127000,127000,0,1,0.0,-5154.0
2013-04-13,127000,127000,0,1,0.0,-5154.0
2013-04-14,127000,126000,-1000,1,-1000.0,-6154.0
2013-04-15,126000,123000,-3000,1,-3000.0,-9154.0
2013-04-16,123000,122000,-1000,1,-1000.0,-10154.0
2013-04-17,122000,120500,-1500,1,-1500.0,-11654.0
2013-04-18,120500,120500,0,1,0.0,-11654.0
2013-04-19,120500,120500,0,1,0.0,-11654.0
2013-04-20,120500,120500,0,1,0.0,-11654.0
2013-04-21,120500,121500,1000,1,1000.0,-10654.0
2013-04-22,121500,121500,0,1,0.0,-10654.0
2013-04-23,121500,123000,1500,1,1500.0,-9154.0
2013-04-24,123000,123000,0,1,0.0,-9154.0
2013-04-25,123000,123000,0,1,0.0,-9154.0
2013-04-26,123000,123000,0,1,0.0,-9154.0
2013-04-27,123000,123000,0,1,0.0,-9154.0
2013-04-28,123000,123000,0,1,0.0,-9154.0
2013-04-29,123000,123000,0,1,0.0,-9154.0
2013-04-30,123000,123000,0,1,0.0,-9154.0
2013-05-01,123000,122000,-1000,1,-1000.0,-10154.0
2013-05-02,122000,122500,500,1,500.0,-9654.0
2013-05-03,122500,122500,0,1,0.0,-9654.0
2013-05-04,122500,122500,0,1,0.0,-9654.0
2013-05-05,122500,126000,3500,1,3500.0,-6154.0
2013-05-06,126000,127500,1500,1,1500.0,-4654.0
2013-05-07,127500,129000,1500,1,1500.0,-3154.0
2013-05-08,129000,131000,2000,1,2000.0,-1154.0
2013-05-09,131000,130500,-500,1,-500.0,-1654.0
2013-05-10,130500,130500,0,1,0.0,-1654.0
2013-05-11,130500,130500,0,1,0.0,-1654.0
2013-05-12,130500,131500,1000,1,1000.0,-654.0
2013-05-13,131500,132500,1000,1,1000.0,346.0
2013-05-14,132500,135000,2500,1,2500.0,2846.0
2013-05-15,135000,139000,4000,1,4000.0,6846.0
2013-05-16,139000,139000,0,1,0.0,6846.0
2013-05-17,139000,139000,0,1,0.0,6846.0
2013-05-18,139000,139000,0,1,0.0,6846.0
2013-05-19,139000,138500,-500,1,-500.0,6346.0
2013-05-20,138500,137500,-1000,1,-1000.0,5346.0
2013-05-21,137500,137000,-500,1,-500.0,4846.0
2013-05-22,137000,138000,1000,1,1000.0,5846.0
2013-05-23,138000,139000,1000,1,1000.0,6846.0
2013-05-24,139000,139000,0,1,0.0,6846.0
2013-05-25,139000,139000,0,1,0.0,6846.0
2013-05-26,139000,140000,1000,1,1000.0,7846.0
2013-05-27,140000,141000,1000,1,1000.0,8846.0
2013-05-28,141000,143000,2000,1,2000.0,10846.0
2013-05-29,143000,141500,-1500,1,-1500.0,9346.0
2013-05-30,141500,142000,500,1,500.0,9846.0
2013-05-31,142000,142000,0,1,0.0,9846.0
2013-06-01,142000,142000,0,1,0.0,9846.0
2013-06-02,142000,140500,-1500,1,-1500.0,8346.0
2013-06-03,140500,138500,-2000,1,-2000.0,6346.0
2013-06-04,138500,137500,-1000,1,-1000.0,5346.0
2013-06-05,137500,137500,0,1,0.0,5346.0
2013-06-06,137500,139500,2000,1,2000.0,7346.0
2013-06-07,139500,139500,0,1,0.0,7346.0
2013-06-08,139500,139500,0,1,0.0,7346.0
2013-06-09,139500,138500,-1000,1,-1000.0,6346.0
2013-06-10,138500,137000,-1500,1,-1500.0,4846.0
2013-06-11,137000,136000,-1000,1,-1000.0,3846.0
2013-06-12,136000,132000,-4000,1,-4000.0,-154.0
2013-06-13,132000,133000,1000,1,1000.0,846.0
2013-06-14,133000,133000,0,1,0.0,846.0
2013-06-15,133000,133000,0,1,0.0,846.0
2013-06-16,133000,134000,1000,1,1000.0,1846.0
2013-06-17,134000,136500,2500,1,2500.0,4346.0
2013-06-18,136500,134000,-2500,1,-2500.0,1846.0
2013-06-19,134000,130500,-3500,1,-3500.0,-1654.0
2013-06-20,130500,127500,-3000,1,-3000.0,-4654.0
2013-06-21,127500,127500,0,1,0.0,-4654.0
2013-06-22,127500,127500,0,1,0.0,-4654.0
2013-06-23,127500,127000,-500,1,-500.0,-5154.0
2013-06-24,127000,124000,-3000,1,-3000.0,-8154.0
2013-06-25,124000,125000,1000,1,1000.0,-7154.0
2013-06-26,125000,126500,1500,1,1500.0,-5654.0
2013-06-27,126500,128500,2000,1,2000.0,-3654.0
2013-06-28,128500,128500,0,1,0.0,-3654.0
2013-06-29,128500,128500,0,1,0.0,-3654.0
2013-06-30,128500,127000,-1500,1,-1500.0,-5154.0
2013-07-01,127000,128500,1500,1,1500.0,-3654.0
2013-07-02,128500,125000,-3500,1,-3500.0,-7154.0
2013-07-03,125000,125500,500,1,500.0,-6654.0
2013-07-04,125500,125000,-500,1,-500.0,-7154.0
2013-07-05,125000,125000,0,1,0.0,-7154.0
2013-07-06,125000,125000,0,1,0.0,-7154.0
2013-07-07,125000,125000,0,1,0.0,-7154.0
2013-07-08,125000,126000,1000,1,1000.0,-6154.0
2013-07-09,126000,126000,0,1,0.0,-6154.0
2013-07-10,126000,130000,4000,1,4000.0,-2154.0
2013-07-11,130000,129500,-500,1,-500.0,-2654.0
2013-07-12,129500,129500,0,1,0.0,-2654.0
2013-07-13,129500,129500,0,1,0.0,-2654.0
2013-07-14,129500,127500,-2000,1,-2000.0,-4654.0
2013-07-15,127500,128500,1000,1,1000.0,-3654.0
2013-07-16,128500,131500,3000,1,3000.0,-654.0
2013-07-17,131500,131000,-500,1,-500.0,-1154.0
2013-07-18,131000,131500,500,1,500.0,-654.0
2013-07-19,131500,131500,0,1,0.0,-654.0
2013-07-20,131500,131500,0,1,0.0,-654.0
2013-07-21,131500,131500,0,1,0.0,-654.0
2013-07-22,131500,135000,3500,1,3500.0,2846.0
2013-07-23,135000,139500,4500,1,4500.0,7346.0
2013-07-24,139500,140000,500,1,500.0,7846.0
2013-07-25,140000,138500,-1500,1,-1500.0,6346.0
2013-07-26,138500,138500,0,1,0.0,6346.0
2013-07-27,138500,138500,0,1,0.0,6346.0
2013-07-28,138500,139000,500,1,500.0,6846.0
2013-07-29,139000,140500,1500,1,1500.0,8346.0
2013-07-30,140500,142500,2000,1,2000.0,10346.0
2013-07-31,142500,143000,500,1,500.0,10846.0
2013-08-01,143000,144000,1000,1,1000.0,11846.0
2013-08-02,144000,144000,0,1,0.0,11846.0
2013-08-03,144000,144000,0,1,0.0,11846.0
2013-08-04,144000,142000,-2000,1,-2000.0,9846.0
2013-08-05,142000,140000,-2000,1,-2000.0,7846.0
2013-08-06,140000,139500,-500,1,-500.0,7346.0
2013-08-07,139500,142000,2500,1,2500.0,9846.0
2013-08-08,142000,142500,500,1,500.0,10346.0
2013-08-09,142500,142500,0,1,0.0,10346.0
2013-08-10,142500,142500,0,1,0.0,10346.0
2013-08-11,142500,142500,0,1,0.0,10346.0
2013-08-12,142500,139500,-3000,1,-3000.0,7346.0
2013-08-13,139500,142500,3000,1,3000.0,10346.0
2013-08-14,142500,142500,0,1,0.0,10346.0
2013-08-15,142500,141000,-1500,1,-1500.0,8846.0
2013-08-16,141000,141000,0,1,0.0,8846.0
2013-08-17,141000,141000,0,1,0.0,8846.0
2013-08-18,141000,138000,-3000,1,-3000.0,5846.0
2013-08-19,138000,138500,500,1,500.0,6346.0
2013-08-20,138500,137500,-1000,1,-1000.0,5346.0
2013-08-21,137500,136500,-1000,1,-1000.0,4346.0
2013-08-22,136500,136500,0,1,0.0,4346.0
2013-08-23,136500,136500,0,1,0.0,4346.0
2013-08-24,136500,136500,0,1,0.0,4346.0
2013-08-25,136500,138000,1500,1,1500.0,5846.0
2013-08-26,138000,138000,0,1,0.0,5846.0
2013-08-27,138000,135500,-2500,1,-2500.0,3346.0
2013-08-28,135500,137000,1500,1,1500.0,4846.0
2013-08-29,137000,138500,1500,1,1500.0,6346.0
2013-08-30,138500,138500,0,1,0.0,6346.0
2013-08-31,138500,138500,0,1,0.0,6346.0
2013-09-01,138500,140500,2000,1,2000.0,8346.0
2013-09-02,140500,145000,4500,1,4500.0,12846.0
2013-09-03,145000,145000,0,1,0.0,12846.0
2013-09-04,145000,145000,0,1,0.0,12846.0
2013-09-05,145000,147000,2000,1,2000.0,14846.0
2013-09-06,147000,147000,0,1,0.0,14846.0
2013-09-07,147000,147000,0,1,0.0,14846.0
2013-09-08,147000,149000,2000,1,2000.0,16846.0
2013-09-09,149000,151500,2500,1,2500.0,19346.0
2013-09-10,151500,149000,-2500,1,-2500.0,16846.0
2013-09-11,149000,151000,2000,1,2000.0,18846.0
2013-09-12,151000,151000,0,1,0.0,18846.0
2013-09-13,151000,151000,0,1,0.0,18846.0
2013-09-14,151000,151000,0,1,0.0,18846.0
2013-09-15,151000,148000,-3000,1,-3000.0,15846.0
2013-09-16,148000,151000,3000,1,3000.0,18846.0
2013-09-17,151000,151000,0,1,0.0,18846.0
2013-09-18,151000,151000,0,1,0.0,18846.0
2013-09-19,151000,151000,0,1,0.0,18846.0
2013-09-20,151000,151000,0,1,0.0,18846.0
2013-09-21,151000,151000,0,1,0.0,18846.0
2013-09-22,151000,151500,500,1,500.0,19346.0
2013-09-23,151500,150500,-1000,1,-1000.0,18346.0
2013-09-24,150500,152000,1500,1,1500.0,19846.0
2013-09-25,152000,149500,-2500,1,-2500.0,17346.0
2013-09-26,149500,145500,-4000,1,-4000.0,13346.0
2013-09-27,145500,145500,0,1,0.0,13346.0
2013-09-28,145500,145500,0,1,0.0,13346.0
2013-09-29,145500,151000,5500,1,5500.0,18846.0
2013-09-30,151000,148000,-3000,1,-3000.0,15846.0
2013-10-01,148000,144000,-4000,1,-4000.0,11846.0
2013-10-02,144000,144000,0,1,0.0,11846.0
2013-10-03,144000,145500,1500,1,1500.0,13346.0
2013-10-04,145500,145500,0,1,0.0,13346.0
2013-10-05,145500,145500,0,1,0.0,13346.0
2013-10-06,145500,146500,1000,1,1000.0,14346.0
2013-10-07,146500,143000,-3500,1,-3500.0,10846.0
2013-10-08,143000,143000,0,1,0.0,10846.0
2013-10-09,143000,144500,1500,1,1500.0,12346.0
2013-10-10,144500,148500,4000,1,4000.0,16346.0
2013-10-11,148500,148500,0,1,0.0,16346.0
2013-10-12,148500,148500,0,1,0.0,16346.0
2013-10-13,148500,144000,-4500,1,-4500.0,11846.0
2013-10-14,144000,147000,3000,1,3000.0,14846.0
2013-10-15,147000,145500,-1500,1,-1500.0,13346.0
2013-10-16,145500,143000,-2500,1,-2500.0,10846.0
2013-10-17,143000,142000,-1000,1,-1000.0,9846.0
2013-10-18,142000,142000,0,1,0.0,9846.0
2013-10-19,142000,142000,0,1,0.0,9846.0
2013-10-20,142000,143000,1000,1,1000.0,10846.0
2013-10-21,143000,148000,5000,1,5000.0,15846.0
2013-10-22,148000,145000,-3000,1,-3000.0,12846.0
2013-10-23,145000,146500,1500,1,1500.0,14346.0
2013-10-24,146500,142500,-4000,1,-4000.0,10346.0
2013-10-25,142500,142500,0,1,0.0,10346.0
2013-10-26,142500,142500,0,1,0.0,10346.0
2013-10-27,142500,145000,2500,1,2500.0,12846.0
2013-10-28,145000,143000,-2000,1,-2000.0,10846.0
2013-10-29,143000,145000,2000,1,2000.0,12846.0
2013-10-30,145000,142000,-3000,1,-3000.0,9846.0
2013-10-31,142000,144000,2000,1,2000.0,11846.0
2013-11-01,144000,144000,0,1,0.0,11846.0
2013-11-02,144000,144000,0,1,0.0,11846.0
2013-11-03,144000,141500,-2500,1,-2500.0,9346.0
2013-11-04,141500,139000,-2500,1,-2500.0,6846.0
2013-11-05,139000,136000,-3000,1,-3000.0,3846.0
2013-11-06,136000,134500,-1500,1,-1500.0,2346.0
2013-11-07,134500,131000,-3500,1,-3500.0,-1154.0
2013-11-08,131000,131000,0,1,0.0,-1154.0
2013-11-09,131000,131000,0,1,0.0,-1154.0
2013-11-10,131000,132000,1000,1,1000.0,-154.0
2013-11-11,132000,135000,3000,1,3000.0,2846.0
2013-11-12,135000,133000,-2000,1,-2000.0,846.0
2013-11-13,133000,134500,1500,1,1500.0,2346.0
2013-11-14,134500,140000,5500,1,5500.0,7846.0
2013-11-15,140000,140000,0,1,0.0,7846.0
2013-11-16,140000,140000,0,1,0.0,7846.0
2013-11-17,140000,140000,0,1,0.0,7846.0
2013-11-18,140000,140000,0,1,0.0,7846.0
2013-11-19,140000,137500,-2500,1,-2500.0,5346.0
2013-11-20,137500,136500,-1000,1,-1000.0,4346.0
2013-11-21,136500,136000,-500,1,-500.0,3846.0
2013-11-22,136000,136000,0,1,0.0,3846.0
2013-11-23,136000,136000,0,1,0.0,3846.0
2013-11-24,136000,137000,1000,1,1000.0,4846.0
2013-11-25,137000,137500,500,1,500.0,5346.0
2013-11-26,137500,132500,-5000,1,-5000.0,346.0
2013-11-27,132500,134500,2000,1,2000.0,2346.0
2013-11-28,134500,136000,1500,1,1500.0,3846.0
2013-11-29,136000,136000,0,1,0.0,3846.0
2013-11-30,136000,136000,0,1,0.0,3846.0
2013-12-01,136000,132000,-4000,1,-4000.0,-154.0
2013-12-02,132000,132000,0,1,0.0,-154.0
2013-12-03,132000,130500,-1500,1,-1500.0,-1654.0
2013-12-04,130500,130000,-500,1,-500.0,-2154.0
2013-12-05,130000,125500,-4500,1,-4500.0,-6654.0
2013-12-06,125500,125500,0,1,0.0,-6654.0
2013-12-07,125500,125500,0,1,0.0,-6654.0
2013-12-08,125500,127500,2000,1,2000.0,-4654.0
2013-12-09,127500,129500,2000,1,2000.0,-2654.0
2013-12-10,129500,128000,-1500,1,-1500.0,-4154.0
2013-12-11,128000,131000,3000,1,3000.0,-1154.0
2013-12-12,131000,131000,0,1,0.0,-1154.0
2013-12-13,131000,131000,0,1,0.0,-1154.0
2013-12-14,131000,131000,0,1,0.0,-1154.0
2013-12-15,131000,135500,4500,1,4500.0,3346.0
2013-12-16,135500,139000,3500,1,3500.0,6846.0
2013-12-17,139000,136500,-2500,1,-2500.0,4346.0
2013-12-18,136500,134500,-2000,1,-2000.0,2346.0
2013-12-19,134500,134500,0,1,0.0,2346.0
2013-12-20,134500,134500,0,1,0.0,2346.0
2013-12-21,134500,134500,0,1,0.0,2346.0
2013-12-22,134500,139500,5000,1,5000.0,7346.0
2013-12-23,139500,137000,-2500,1,-2500.0,4846.0
2013-12-24,137000,137000,0,1,0.0,4846.0
2013-12-25,137000,138000,1000,1,1000.0,5846.0
2013-12-26,138000,141500,3500,1,3500.0,9346.0
2013-12-27,141500,141500,0,1,0.0,9346.0
2013-12-28,141500,141500,0,1,0.0,9346.0
2013-12-29,141500,139500,-2000,1,-2000.0,7346.0
2013-12-30,139500,139500,0,1,0.0,7346.0
2013-12-31,139500,139500,0,1,0.0,7346.0
2014-01-01,139500,133500,-6000,1,-6000.0,1346.0
2014-01-02,133500,133000,-500,1,-500.0,846.0
2014-01-03,133000,133000,0,1,0.0,846.0
2014-01-04,133000,133000,0,1,0.0,846.0
2014-01-05,133000,133000,0,1,0.0,846.0
2014-01-06,133000,133000,0,1,0.0,846.0
2014-01-07,133000,133000,0,1,0.0,846.0
2014-01-08,133000,132000,-1000,1,-1000.0,-154.0
2014-01-09,132000,133000,1000,1,1000.0,846.0
2014-01-10,133000,133000,0,1,0.0,846.0
2014-01-11,133000,133000,0,1,0.0,846.0
2014-01-12,133000,131000,-2000,1,-2000.0,-1154.0
2014-01-13,131000,133000,2000,1,2000.0,846.0
2014-01-14,133000,135000,2000,1,2000.0,2846.0
2014-01-15,135000,134000,-1000,1,-1000.0,1846.0
2014-01-16,134000,131500,-2500,1,-2500.0,-654.0
2014-01-17,131500,131500,0,1,0.0,-654.0
2014-01-18,131500,131500,0,1,0.0,-654.0
2014-01-19,131500,131000,-500,1,-500.0,-1154.0
2014-01-20,131000,133000,2000,1,2000.0,846.0
2014-01-21,133000,134500,1500,1,1500.0,2346.0
2014-01-22,134500,132500,-2000,1,-2000.0,346.0
2014-01-23,132500,132000,-500,1,-500.0,-154.0
2014-01-24,132000,132000,0,1,0.0,-154.0
2014-01-25,132000,132000,0,1,0.0,-154.0
2014-01-26,132000,128000,-4000,1,-4000.0,-4154.0
2014-01-27,128000,128500,500,1,500.0,-3654.0
2014-01-28,128500,136500,8000,1,8000.0,4346.0
2014-01-29,136500,136500,0,1,0.0,4346.0
2014-01-30,136500,136500,0,1,0.0,4346.0
2014-01-31,136500,136500,0,1,0.0,4346.0
2014-02-01,136500,136500,0,1,0.0,4346.0
2014-02-02,136500,130500,-6000,1,-6000.0,-1654.0
2014-02-03,130500,128000,-2500,1,-2500.0,-4154.0
2014-02-04,128000,127500,-500,1,-500.0,-4654.0
2014-02-05,127500,130000,2500,1,2500.0,-2154.0
2014-02-06,130000,129500,-500,1,-500.0,-2654.0
2014-02-07,129500,129500,0,1,0.0,-2654.0
2014-02-08,129500,129500,0,1,0.0,-2654.0
2014-02-09,129500,132000,2500,1,2500.0,-154.0
2014-02-10,132000,132000,0,1,0.0,-154.0
2014-02-11,132000,133500,1500,1,1500.0,1346.0
2014-02-12,133500,131000,-2500,1,-2500.0,-1154.0
2014-02-13,131000,133000,2000,1,2000.0,846.0
2014-02-14,133000,133000,0,1,0.0,846.0
2014-02-15,133000,133000,0,1,0.0,846.0
2014-02-16,133000,134500,1500,1,1500.0,2346.0
2014-02-17,134500,134000,-500,1,-500.0,1846.0
2014-02-18,134000,132500,-1500,1,-1500.0,346.0
2014-02-19,132500,137000,4500,1,4500.0,4846.0
2014-02-20,137000,136500,-500,1,-500.0,4346.0
2014-02-21,136500,136500,0,1,0.0,4346.0
2014-02-22,136500,136500,0,1,0.0,4346.0
2014-02-23,136500,137500,1000,1,1000.0,5346.0
2014-02-24,137500,137500,0,1,0.0,5346.0
2014-02-25,137500,135500,-2000,1,-2000.0,3346.0
2014-02-26,135500,139500,4000,1,4000.0,7346.0
2014-02-27,139500,138000,-1500,1,-1500.0,5846.0
2014-02-28,138000,138000,0,1,0.0,5846.0
2014-03-01,138000,138000,0,1,0.0,5846.0
2014-03-02,138000,139000,1000,1,1000.0,6846.0
2014-03-03,139000,133500,-5500,1,-5500.0,1346.0
2014-03-04,133500,137000,3500,1,3500.0,4846.0
2014-03-05,137000,137500,500,1,500.0,5346.0
2014-03-06,137500,136000,-1500,1,-1500.0,3846.0
2014-03-07,136000,136000,0,1,0.0,3846.0
2014-03-08,136000,136000,0,1,0.0,3846.0
2014-03-09,136000,134000,-2000,1,-2000.0,1846.0
2014-03-10,134000,134500,500,1,500.0,2346.0
2014-03-11,134500,133500,-1000,1,-1000.0,1346.0
2014-03-12,133500,132500,-1000,1,-1000.0,346.0
2014-03-13,132500,134000,1500,1,1500.0,1846.0
2014-03-14,134000,134000,0,1,0.0,1846.0
2014-03-15,134000,134000,0,1,0.0,1846.0
2014-03-16,134000,134000,0,1,0.0,1846.0
2014-03-17,134000,134000,0,1,0.0,1846.0
2014-03-18,134000,131500,-2500,1,-2500.0,-654.0
2014-03-19,131500,130000,-1500,1,-1500.0,-2154.0
2014-03-20,130000,130500,500,1,500.0,-1654.0
2014-03-21,130500,130500,0,1,0.0,-1654.0
2014-03-22,130500,130500,0,1,0.0,-1654.0
2014-03-23,130500,133500,3000,1,3000.0,1346.0
2014-03-24,133500,135000,1500,1,1500.0,2846.0
2014-03-25,135000,135000,0,1,0.0,2846.0
2014-03-26,135000,133500,-1500,1,-1500.0,1346.0
2014-03-27,133500,138000,4500,1,4500.0,5846.0
2014-03-28,138000,138000,0,1,0.0,5846.0
2014-03-29,138000,138000,0,1,0.0,5846.0
2014-03-30,138000,138500,500,1,500.0,6346.0
2014-03-31,138500,137500,-1000,1,-1000.0,5346.0
2014-04-01,137500,134500,-3000,1,-3000.0,2346.0
2014-04-02,134500,132500,-2000,1,-2000.0,346.0
2014-04-03,132500,133000,500,1,500.0,846.0
2014-04-04,133000,133000,0,1,0.0,846.0
2014-04-05,133000,133000,0,1,0.0,846.0
2014-04-06,133000,134000,1000,1,1000.0,1846.0
2014-04-07,134000,133000,-1000,1,-1000.0,846.0
2014-04-08,133000,136500,3500,1,3500.0,4346.0
2014-04-09,136500,137000,500,1,500.0,4846.0
2014-04-10,137000,134000,-3000,1,-3000.0,1846.0
2014-04-11,134000,134000,0,1,0.0,1846.0
2014-04-12,134000,134000,0,1,0.0,1846.0
2014-04-13,134000,135500,1500,1,1500.0,3346.0
2014-04-14,135500,133000,-2500,1,-2500.0,846.0
2014-04-15,133000,133500,500,1,500.0,1346.0
2014-04-16,133500,134500,1000,1,1000.0,2346.0
2014-04-17,134500,135500,1000,1,1000.0,3346.0
2014-04-18,135500,135500,0,1,0.0,3346.0
2014-04-19,135500,135500,0,1,0.0,3346.0
2014-04-20,135500,137000,1500,1,1500.0,4846.0
2014-04-21,137000,135500,-1500,1,-1500.0,3346.0
2014-04-22,135500,135500,0,1,0.0,3346.0
2014-04-23,135500,136000,500,1,500.0,3846.0
2014-04-24,136000,134500,-1500,1,-1500.0,2346.0
2014-04-25,134500,134500,0,1,0.0,2346.0
2014-04-26,134500,134500,0,1,0.0,2346.0
2014-04-27,134500,132500,-2000,1,-2000.0,346.0
2014-04-28,132500,133500,1000,1,1000.0,1346.0
2014-04-29,133500,133000,-500,1,-500.0,846.0
2014-04-30,133000,133000,0,1,0.0,846.0
2014-05-01,133000,132500,-500,1,-500.0,346.0
2014-05-02,132500,132500,0,1,0.0,346.0
2014-05-03,132500,132500,0,1,0.0,346.0
2014-05-04,132500,132500,0,1,0.0,346.0
2014-05-05,132500,132500,0,1,0.0,346.0
2014-05-06,132500,128500,-4000,1,-4000.0,-3654.0
2014-05-07,128500,131000,2500,1,2500.0,-1154.0
2014-05-08,131000,130000,-1000,1,-1000.0,-2154.0
2014-05-09,130000,130000,0,1,0.0,-2154.0
2014-05-10,130000,130000,0,1,0.0,-2154.0
2014-05-11,130000,132000,2000,1,2000.0,-154.0
2014-05-12,132000,130000,-2000,1,-2000.0,-2154.0
2014-05-13,130000,131000,1000,1,1000.0,-1154.0
2014-05-14,131000,131000,0,1,0.0,-1154.0
2014-05-15,131000,131500,500,1,500.0,-654.0
2014-05-16,131500,131500,0,1,0.0,-654.0
2014-05-17,131500,131500,0,1,0.0,-654.0
2014-05-18,131500,129000,-2500,1,-2500.0,-3154.0
2014-05-19,129000,130500,1500,1,1500.0,-1654.0
2014-05-20,130500,130000,-500,1,-500.0,-2154.0
2014-05-21,130000,133000,3000,1,3000.0,846.0
2014-05-22,133000,129500,-3500,1,-3500.0,-2654.0
2014-05-23,129500,129500,0,1,0.0,-2654.0
2014-05-24,129500,129500,0,1,0.0,-2654.0
2014-05-25,129500,129000,-500,1,-500.0,-3154.0
2014-05-26,129000,129000,0,1,0.0,-3154.0
2014-05-27,129000,131000,2000,1,2000.0,-1154.0
2014-05-28,131000,130000,-1000,1,-1000.0,-2154.0
2014-05-29,130000,127500,-2500,1,-2500.0,-4654.0
2014-05-30,127500,127500,0,1,0.0,-4654.0
2014-05-31,127500,127500,0,1,0.0,-4654.0
2014-06-01,127500,127500,0,1,0.0,-4654.0
2014-06-02,127500,127500,0,1,0.0,-4654.0
2014-06-03,127500,127500,0,1,0.0,-4654.0
2014-06-04,127500,125000,-2500,1,-2500.0,-7154.0
2014-06-05,125000,125000,0,1,0.0,-7154.0
2014-06-06,125000,125000,0,1,0.0,-7154.0
2014-06-07,125000,125000,0,1,0.0,-7154.0
2014-06-08,125000,123000,-2000,1,-2000.0,-9154.0
2014-06-09,123000,125000,2000,1,2000.0,-7154.0
2014-06-10,125000,124500,-500,1,-500.0,-7654.0
2014-06-11,124500,125500,1000,1,1000.0,-6654.0
2014-06-12,125500,126500,1000,1,1000.0,-5654.0
2014-06-13,126500,126500,0,1,0.0,-5654.0
2014-06-14,126500,126500,0,1,0.0,-5654.0
2014-06-15,126500,124000,-2500,1,-2500.0,-8154.0
2014-06-16,124000,125000,1000,1,1000.0,-7154.0
2014-06-17,125000,126000,1000,1,1000.0,-6154.0
2014-06-18,126000,128500,2500,1,2500.0,-3654.0
2014-06-19,128500,124000,-4500,1,-4500.0,-8154.0
2014-06-20,124000,124000,0,1,0.0,-8154.0
2014-06-21,124000,124000,0,1,0.0,-8154.0
2014-06-22,124000,125000,1000,1,1000.0,-7154.0
2014-06-23,125000,124500,-500,1,-500.0,-7654.0
2014-06-24,124500,123000,-1500,1,-1500.0,-9154.0
2014-06-25,123000,125000,2000,1,2000.0,-7154.0
2014-06-26,125000,124000,-1000,1,-1000.0,-8154.0
2014-06-27,124000,124000,0,1,0.0,-8154.0
2014-06-28,124000,124000,0,1,0.0,-8154.0
2014-06-29,124000,125000,1000,1,1000.0,-7154.0
2014-06-30,125000,123500,-1500,1,-1500.0,-8654.0
2014-07-01,123500,123000,-500,1,-500.0,-9154.0
2014-07-02,123000,118500,-4500,1,-4500.0,-13654.0
2014-07-03,118500,122000,3500,1,3500.0,-10154.0
2014-07-04,122000,122000,0,1,0.0,-10154.0
2014-07-05,122000,122000,0,1,0.0,-10154.0
2014-07-06,122000,120500,-1500,1,-1500.0,-11654.0
2014-07-07,120500,121000,500,1,500.0,-11154.0
2014-07-08,121000,118500,-2500,1,-2500.0,-13654.0
2014-07-09,118500,117500,-1000,1,-1000.0,-14654.0
2014-07-10,117500,121000,3500,1,3500.0,-11154.0
2014-07-11,121000,121000,0,1,0.0,-11154.0
2014-07-12,121000,121000,0,1,0.0,-11154.0
2014-07-13,121000,121500,500,1,500.0,-10654.0
2014-07-14,121500,120500,-1000,1,-1000.0,-11654.0
2014-07-15,120500,121500,1000,1,1000.0,-10654.0
2014-07-16,121500,122500,1000,1,1000.0,-9654.0
2014-07-17,122500,124000,1500,1,1500.0,-8154.0
2014-07-18,124000,124000,0,1,0.0,-8154.0
2014-07-19,124000,124000,0,1,0.0,-8154.0
2014-07-20,124000,126000,2000,1,2000.0,-6154.0
2014-07-21,126000,125000,-1000,1,-1000.0,-7154.0
2014-07-22,125000,124000,-1000,1,-1000.0,-8154.0
2014-07-23,124000,124500,500,1,500.0,-7654.0
2014-07-24,124500,124500,0,1,0.0,-7654.0
2014-07-25,124500,124500,0,1,0.0,-7654.0
2014-07-26,124500,124500,0,1,0.0,-7654.0
2014-07-27,124500,125500,1000,1,1000.0,-6654.0
2014-07-28,125500,121000,-4500,1,-4500.0,-11154.0
2014-07-29,121000,121500,500,1,500.0,-10654.0
2014-07-30,121500,123500,2000,1,2000.0,-8654.0
2014-07-31,123500,124500,1000,1,1000.0,-7654.0
2014-08-01,124500,124500,0,1,0.0,-7654.0
2014-08-02,124500,124500,0,1,0.0,-7654.0
2014-08-03,124500,123500,-1000,1,-1000.0,-8654.0
2014-08-04,123500,121500,-2000,1,-2000.0,-10654.0
2014-08-05,121500,117000,-4500,1,-4500.0,-15154.0
2014-08-06,117000,117500,500,1,500.0,-14654.0
2014-08-07,117500,118000,500,1,500.0,-14154.0
2014-08-08,118000,118000,0,1,0.0,-14154.0
2014-08-09,118000,118000,0,1,0.0,-14154.0
2014-08-10,118000,117500,-500,1,-500.0,-14654.0
2014-08-11,117500,118000,500,1,500.0,-14154.0
2014-08-12,118000,119500,1500,1,1500.0,-12654.0
2014-08-13,119500,120500,1000,1,1000.0,-11654.0
2014-08-14,120500,120500,0,1,0.0,-11654.0
2014-08-15,120500,120500,0,1,0.0,-11654.0
2014-08-16,120500,120500,0,1,0.0,-11654.0
2014-08-17,120500,119000,-1500,1,-1500.0,-13154.0
2014-08-18,119000,117000,-2000,1,-2000.0,-15154.0
2014-08-19,117000,118500,1500,1,1500.0,-13654.0
2014-08-20,118500,114500,-4000,1,-4000.0,-17654.0
2014-08-21,114500,115500,1000,1,1000.0,-16654.0
2014-08-22,115500,115500,0,1,0.0,-16654.0
2014-08-23,115500,115500,0,1,0.0,-16654.0
2014-08-24,115500,113500,-2000,1,-2000.0,-18654.0
2014-08-25,113500,114500,1000,1,1000.0,-17654.0
2014-08-26,114500,118000,3500,1,3500.0,-14154.0
2014-08-27,118000,123000,5000,1,5000.0,-9154.0
2014-08-28,123000,120500,-2500,1,-2500.0,-11654.0
2014-08-29,120500,120500,0,1,0.0,-11654.0
2014-08-30,120500,120500,0,1,0.0,-11654.0
2014-08-31,120500,117000,-3500,1,-3500.0,-15154.0
2014-09-01,117000,117000,0,1,0.0,-15154.0
2014-09-02,117000,117000,0,1,0.0,-15154.0
2014-09-03,117000,117000,0,1,0.0,-15154.0
2014-09-04,117000,117000,0,1,0.0,-15154.0
2014-09-05,117000,117000,0,1,0.0,-15154.0
2014-09-06,117000,117000,0,1,0.0,-15154.0
2014-09-07,117000,117000,0,1,0.0,-15154.0
2014-09-08,117000,117000,0,1,0.0,-15154.0
2014-09-09,117000,117000,0,1,0.0,-15154.0
2014-09-10,117000,117500,500,1,500.0,-14654.0
2014-09-11,117500,119500,2000,1,2000.0,-12654.0
2014-09-12,119500,119500,0,1,0.0,-12654.0
2014-09-13,119500,119500,0,1,0.0,-12654.0
2014-09-14,119500,119000,-500,1,-500.0,-13154.0
2014-09-15,119000,119000,0,1,0.0,-13154.0
2014-09-16,119000,121500,2500,1,2500.0,-10654.0
2014-09-17,121500,119000,-2500,1,-2500.0,-13154.0
2014-09-18,119000,121000,2000,1,2000.0,-11154.0
2014-09-19,121000,121000,0,1,0.0,-11154.0
2014-09-20,121000,121000,0,1,0.0,-11154.0
2014-09-21,121000,121000,0,1,0.0,-11154.0
2014-09-22,121000,120000,-1000,1,-1000.0,-12154.0
2014-09-23,120000,118500,-1500,1,-1500.0,-13654.0
2014-09-24,118500,119000,500,1,500.0,-13154.0
2014-09-25,119000,116500,-2500,1,-2500.0,-15654.0
2014-09-26,116500,116500,0,1,0.0,-15654.0
2014-09-27,116500,116500,0,1,0.0,-15654.0
2014-09-28,116500,113000,-3500,1,-3500.0,-19154.0
2014-09-29,113000,103500,-9500,1,-9500.0,-28654.0
2014-09-30,103500,105000,1500,1,1500.0,-27154.0
2014-10-01,105000,103000,-2000,1,-2000.0,-29154.0
2014-10-02,103000,103000,0,1,0.0,-29154.0
2014-10-03,103000,103000,0,1,0.0,-29154.0
2014-10-04,103000,103000,0,1,0.0,-29154.0
2014-10-05,103000,104500,1500,1,1500.0,-27654.0
2014-10-06,104500,104500,0,1,0.0,-27654.0
2014-10-07,104500,104500,0,1,0.0,-27654.0
2014-10-08,104500,104500,0,1,0.0,-27654.0
2014-10-09,104500,104000,-500,1,-500.0,-28154.0
2014-10-10,104000,104000,0,1,0.0,-28154.0
2014-10-11,104000,104000,0,1,0.0,-28154.0
2014-10-12,104000,104500,500,1,500.0,-27654.0
2014-10-13,104500,109000,4500,1,4500.0,-23154.0
2014-10-14,109000,106500,-2500,1,-2500.0,-25654.0
2014-10-15,106500,106500,0,1,0.0,-25654.0
2014-10-16,106500,108500,2000,1,2000.0,-23654.0
2014-10-17,108500,108500,0,1,0.0,-23654.0
2014-10-18,108500,108500,0,1,0.0,-23654.0
2014-10-19,108500,109000,500,1,500.0,-23154.0
2014-10-20,109000,108000,-1000,1,-1000.0,-24154.0
2014-10-21,108000,108500,500,1,500.0,-23654.0
2014-10-22,108500,110000,1500,1,1500.0,-22154.0
2014-10-23,110000,112000,2000,1,2000.0,-20154.0
2014-10-24,112000,112000,0,1,0.0,-20154.0
2014-10-25,112000,112000,0,1,0.0,-20154.0
2014-10-26,112000,112000,0,1,0.0,-20154.0
2014-10-27,112000,111000,-1000,1,-1000.0,-21154.0
2014-10-28,111000,114000,3000,1,3000.0,-18154.0
2014-10-29,114000,115000,1000,1,1000.0,-17154.0
2014-10-30,115000,111000,-4000,1,-4000.0,-21154.0
2014-10-31,111000,111000,0,1,0.0,-21154.0
2014-11-01,111000,111000,0,1,0.0,-21154.0
2014-11-02,111000,113000,2000,1,2000.0,-19154.0
2014-11-03,113000,107500,-5500,1,-5500.0,-24654.0
2014-11-04,107500,107000,-500,1,-500.0,-25154.0
2014-11-05,107000,106500,-500,1,-500.0,-25654.0
2014-11-06,106500,111000,4500,1,4500.0,-21154.0
2014-11-07,111000,111000,0,1,0.0,-21154.0
2014-11-08,111000,111000,0,1,0.0,-21154.0
2014-11-09,111000,111500,500,1,500.0,-20654.0
2014-11-10,111500,113000,1500,1,1500.0,-19154.0
2014-11-11,113000,115000,2000,1,2000.0,-17154.0
2014-11-12,115000,117000,2000,1,2000.0,-15154.0
2014-11-13,117000,117500,500,1,500.0,-14654.0
2014-11-14,117500,117500,0,1,0.0,-14654.0
2014-11-15,117500,117500,0,1,0.0,-14654.0
2014-11-16,117500,118000,500,1,500.0,-14154.0
2014-11-17,118000,117500,-500,1,-500.0,-14654.0
2014-11-18,117500,115500,-2000,1,-2000.0,-16654.0
2014-11-19,115500,113500,-2000,1,-2000.0,-18654.0
2014-11-20,113500,116500,3000,1,3000.0,-15654.0
2014-11-21,116500,116500,0,1,0.0,-15654.0
2014-11-22,116500,116500,0,1,0.0,-15654.0
2014-11-23,116500,122500,6000,1,6000.0,-9654.0
2014-11-24,122500,118000,-4500,1,-4500.0,-14154.0
2014-11-25,118000,117500,-500,1,-500.0,-14654.0
2014-11-26,117500,120000,2500,1,2500.0,-12154.0
2014-11-27,120000,115500,-4500,1,-4500.0,-16654.0
2014-11-28,115500,115500,0,1,0.0,-16654.0
2014-11-29,115500,115500,0,1,0.0,-16654.0
2014-11-30,115500,114000,-1500,1,-1500.0,-18154.0
2014-12-01,114000,116500,2500,1,2500.0,-15654.0
2014-12-02,116500,115000,-1500,1,-1500.0,-17154.0
2014-12-03,115000,115500,500,1,500.0,-16654.0
2014-12-04,115500,118500,3000,1,3000.0,-13654.0
2014-12-05,118500,118500,0,1,0.0,-13654.0
2014-12-06,118500,118500,0,1,0.0,-13654.0
2014-12-07,118500,118000,-500,1,-500.0,-14154.0
2014-12-08,118000,115500,-2500,1,-2500.0,-16654.0
2014-12-09,115500,113000,-2500,1,-2500.0,-19154.0
2014-12-10,113000,109000,-4000,1,-4000.0,-23154.0
2014-12-11,109000,112500,3500,1,3500.0,-19654.0
2014-12-12,112500,112500,0,1,0.0,-19654.0
2014-12-13,112500,112500,0,1,0.0,-19654.0
2014-12-14,112500,111000,-1500,1,-1500.0,-21154.0
2014-12-15,111000,111000,0,1,0.0,-21154.0
2014-12-16,111000,109500,-1500,1,-1500.0,-22654.0
2014-12-17,109500,110500,1000,1,1000.0,-21654.0
2014-12-18,110500,111000,500,1,500.0,-21154.0
2014-12-19,111000,111000,0,1,0.0,-21154.0
2014-12-20,111000,111000,0,1,0.0,-21154.0
2014-12-21,111000,110500,-500,1,-500.0,-21654.0
2014-12-22,110500,111500,1000,1,1000.0,-20654.0
2014-12-23,111500,112000,500,1,500.0,-20154.0
2014-12-24,112000,112000,0,1,0.0,-20154.0
2014-12-25,112000,114000,2000,1,2000.0,-18154.0
2014-12-26,114000,114000,0,1,0.0,-18154.0
2014-12-27,114000,114000,0,1,0.0,-18154.0
2014-12-28,114000,105000,-9000,1,-9000.0,-27154.0
2014-12-29,105000,103500,-1500,1,-1500.0,-28654.0
2014-12-30,103500,103500,0,1,0.0,-28654.0
2014-12-31,103500,103500,0,1,0.0,-28654.0
2015-01-01,103500,101500,-2000,1,-2000.0,-30654.0
2015-01-02,101500,101500,0,1,0.0,-30654.0
2015-01-03,101500,101500,0,1,0.0,-30654.0
2015-01-04,101500,102000,500,1,500.0,-30154.0
2015-01-05,102000,100000,-2000,1,-2000.0,-32154.0
2015-01-06,100000,101500,1500,1,1500.0,-30654.0
2015-01-07,101500,101500,0,1,0.0,-30654.0
2015-01-08,101500,104000,2500,1,2500.0,-28154.0
2015-01-09,104000,104000,0,1,0.0,-28154.0
2015-01-10,104000,104000,0,1,0.0,-28154.0
2015-01-11,104000,102000,-2000,1,-2000.0,-30154.0
2015-01-12,102000,102000,0,1,0.0,-30154.0
2015-01-13,102000,102500,500,1,500.0,-29654.0
2015-01-14,102500,102500,0,1,0.0,-29654.0
2015-01-15,102500,100500,-2000,1,-2000.0,-31654.0
2015-01-16,100500,100500,0,1,0.0,-31654.0
2015-01-17,100500,100500,0,1,0.0,-31654.0
2015-01-18,100500,101000,500,1,500.0,-31154.0
2015-01-19,101000,102500,1500,1,1500.0,-29654.0
2015-01-20,102500,102000,-500,1,-500.0,-30154.0
2015-01-21,102000,105500,3500,1,3500.0,-26654.0
2015-01-22,105500,104500,-1000,1,-1000.0,-27654.0
2015-01-23,104500,104500,0,1,0.0,-27654.0
2015-01-24,104500,104500,0,1,0.0,-27654.0
2015-01-25,104500,104500,0,1,0.0,-27654.0
2015-01-26,104500,106500,2000,1,2000.0,-25654.0
2015-01-27,106500,107500,1000,1,1000.0,-24654.0
2015-01-28,107500,105500,-2000,1,-2000.0,-26654.0
2015-01-29,105500,104000,-1500,1,-1500.0,-28154.0
2015-01-30,104000,104000,0,1,0.0,-28154.0
2015-01-31,104000,104000,0,1,0.0,-28154.0
2015-02-01,104000,104000,0,1,0.0,-28154.0
2015-02-02,104000,107500,3500,1,3500.0,-24654.0
2015-02-03,107500,110500,3000,1,3000.0,-21654.0
2015-02-04,110500,116000,5500,1,5500.0,-16154.0
2015-02-05,116000,118000,2000,1,2000.0,-14154.0
2015-02-06,118000,118000,0,1,0.0,-14154.0
2015-02-07,118000,118000,0,1,0.0,-14154.0
2015-02-08,118000,118500,500,1,500.0,-13654.0
2015-02-09,118500,117000,-1500,1,-1500.0,-15154.0
2015-02-10,117000,117000,0,1,0.0,-15154.0
2015-02-11,117000,118500,1500,1,1500.0,-13654.0
2015-02-12,118500,117000,-1500,1,-1500.0,-15154.0
2015-02-13,117000,117000,0,1,0.0,-15154.0
2015-02-14,117000,117000,0,1,0.0,-15154.0
2015-02-15,117000,121500,4500,1,4500.0,-10654.0
2015-02-16,121500,125000,3500,1,3500.0,-7154.0
2015-02-17,125000,125000,0,1,0.0,-7154.0
2015-02-18,125000,125000,0,1,0.0,-7154.0
2015-02-19,125000,125000,0,1,0.0,-7154.0
2015-02-20,125000,125000,0,1,0.0,-7154.0
2015-02-21,125000,125000,0,1,0.0,-7154.0
2015-02-22,125000,120500,-4500,1,-4500.0,-11654.0
2015-02-23,120500,124000,3500,1,3500.0,-8154.0
2015-02-24,124000,122500,-1500,1,-1500.0,-9654.0
2015-02-25,122500,122000,-500,1,-500.0,-10154.0
2015-02-26,122000,119500,-2500,1,-2500.0,-12654.0
2015-02-27,119500,119500,0,1,0.0,-12654.0
2015-02-28,119500,119500,0,1,0.0,-12654.0
2015-03-01,119500,123500,4000,1,4000.0,-8654.0
2015-03-02,123500,122500,-1000,1,-1000.0,-9654.0
2015-03-03,122500,121000,-1500,1,-1500.0,-11154.0
2015-03-04,121000,122000,1000,1,1000.0,-10154.0
2015-03-05,122000,125000,3000,1,3000.0,-7154.0
2015-03-06,125000,125000,0,1,0.0,-7154.0
2015-03-07,125000,125000,0,1,0.0,-7154.0
2015-03-08,125000,122000,-3000,1,-3000.0,-10154.0
2015-03-09,122000,120500,-1500,1,-1500.0,-11654.0
2015-03-10,120500,120000,-500,1,-500.0,-12154.0
2015-03-11,120000,117500,-2500,1,-2500.0,-14654.0
2015-03-12,117500,118000,500,1,500.0,-14154.0
2015-03-13,118000,118000,0,1,0.0,-14154.0
2015-03-14,118000,118000,0,1,0.0,-14154.0
2015-03-15,118000,116000,-2000,1,-2000.0,-16154.0
2015-03-16,116000,117000,1000,1,1000.0,-15154.0
2015-03-17,117000,119500,2500,1,2500.0,-12654.0
2015-03-18,119500,123000,3500,1,3500.0,-9154.0
2015-03-19,123000,125000,2000,1,2000.0,-7154.0
2015-03-20,125000,125000,0,1,0.0,-7154.0
2015-03-21,125000,125000,0,1,0.0,-7154.0
2015-03-22,125000,120500,-4500,1,-4500.0,-11654.0
2015-03-23,120500,121500,1000,1,1000.0,-10654.0
2015-03-24,121500,119000,-2500,1,-2500.0,-13154.0
2015-03-25,119000,117000,-2000,1,-2000.0,-15154.0
2015-03-26,117000,116000,-1000,1,-1000.0,-16154.0
2015-03-27,116000,116000,0,1,0.0,-16154.0
2015-03-28,116000,116000,0,1,0.0,-16154.0
2015-03-29,116000,115500,-500,1,-500.0,-16654.0
2015-03-30,115500,116500,1000,1,1000.0,-15654.0
2015-03-31,116500,108500,-8000,1,-8000.0,-23654.0
2015-04-01,108500,112000,3500,1,3500.0,-20154.0
2015-04-02,112000,111500,-500,1,-500.0,-20654.0
2015-04-03,111500,111500,0,1,0.0,-20654.0
2015-04-04,111500,111500,0,1,0.0,-20654.0
2015-04-05,111500,106500,-5000,1,-5000.0,-25654.0
2015-04-06,106500,110000,3500,1,3500.0,-22154.0
2015-04-07,110000,112500,2500,1,2500.0,-19654.0
2015-04-08,112500,118500,6000,1,6000.0,-13654.0
2015-04-09,118500,117000,-1500,1,-1500.0,-15154.0
2015-04-10,117000,117000,0,1,0.0,-15154.0
2015-04-11,117000,117000,0,1,0.0,-15154.0
2015-04-12,117000,116500,-500,1,-500.0,-15654.0
2015-04-13,116500,122500,6000,1,6000.0,-9654.0
2015-04-14,122500,120500,-2000,1,-2000.0,-11654.0
2015-04-15,120500,124000,3500,1,3500.0,-8154.0
2015-04-16,124000,121500,-2500,1,-2500.0,-10654.0
2015-04-17,121500,121500,0,1,0.0,-10654.0
2015-04-18,121500,121500,0,1,0.0,-10654.0
2015-04-19,121500,120000,-1500,1,-1500.0,-12154.0
2015-04-20,120000,122500,2500,1,2500.0,-9654.0
2015-04-21,122500,121000,-1500,1,-1500.0,-11154.0
2015-04-22,121000,124000,3000,1,3000.0,-8154.0
2015-04-23,124000,121000,-3000,1,-3000.0,-11154.0
2015-04-24,121000,121000,0,1,0.0,-11154.0
2015-04-25,121000,121000,0,1,0.0,-11154.0
2015-04-26,121000,126500,5500,1,5500.0,-5654.0
2015-04-27,126500,123500,-3000,1,-3000.0,-8654.0
2015-04-28,123500,125000,1500,1,1500.0,-7154.0
2015-04-29,125000,124500,-500,1,-500.0,-7654.0
2015-04-30,124500,124500,0,1,0.0,-7654.0
2015-05-01,124500,124500,0,1,0.0,-7654.0
2015-05-02,124500,124500,0,1,0.0,-7654.0
2015-05-03,124500,123000,-1500,1,-1500.0,-9154.0
2015-05-04,123000,123000,0,1,0.0,-9154.0
2015-05-05,123000,126000,3000,1,3000.0,-6154.0
2015-05-06,126000,122000,-4000,1,-4000.0,-10154.0
2015-05-07,122000,122500,500,1,500.0,-9654.0
2015-05-08,122500,122500,0,1,0.0,-9654.0
2015-05-09,122500,122500,0,1,0.0,-9654.0
2015-05-10,122500,119500,-3000,1,-3000.0,-12654.0
2015-05-11,119500,120500,1000,1,1000.0,-11654.0
2015-05-12,120500,122000,1500,1,1500.0,-10154.0
2015-05-13,122000,125000,3000,1,3000.0,-7154.0
2015-05-14,125000,120500,-4500,1,-4500.0,-11654.0
2015-05-15,120500,120500,0,1,0.0,-11654.0
2015-05-16,120500,120500,0,1,0.0,-11654.0
2015-05-17,120500,120000,-500,1,-500.0,-12154.0
2015-05-18,120000,120500,500,1,500.0,-11654.0
2015-05-19,120500,119000,-1500,1,-1500.0,-13154.0
2015-05-20,119000,117500,-1500,1,-1500.0,-14654.0
2015-05-21,117500,120000,2500,1,2500.0,-12154.0
2015-05-22,120000,120000,0,1,0.0,-12154.0
2015-05-23,120000,120000,0,1,0.0,-12154.0
2015-05-24,120000,120000,0,1,0.0,-12154.0
2015-05-25,120000,123500,3500,1,3500.0,-8654.0
2015-05-26,123500,119000,-4500,1,-4500.0,-13154.0
2015-05-27,119000,115000,-4000,1,-4000.0,-17154.0
2015-05-28,115000,114500,-500,1,-500.0,-17654.0
2015-05-29,114500,114500,0,1,0.0,-17654.0
2015-05-30,114500,114500,0,1,0.0,-17654.0
2015-05-31,114500,111000,-3500,1,-3500.0,-21154.0
2015-06-01,111000,112000,1000,1,1000.0,-20154.0
2015-06-02,112000,111500,-500,1,-500.0,-20654.0
2015-06-03,111500,110500,-1000,1,-1000.0,-21654.0
2015-06-04,110500,108000,-2500,1,-2500.0,-24154.0
2015-06-05,108000,108000,0,1,0.0,-24154.0
2015-06-06,108000,108000,0,1,0.0,-24154.0
2015-06-07,108000,106500,-1500,1,-1500.0,-25654.0
2015-06-08,106500,106500,0,1,0.0,-25654.0
2015-06-09,106500,106500,0,1,0.0,-25654.0
2015-06-10,106500,106500,0,1,0.0,-25654.0
2015-06-11,106500,102500,-4000,1,-4000.0,-29654.0
2015-06-12,102500,102500,0,1,0.0,-29654.0
2015-06-13,102500,102500,0,1,0.0,-29654.0
2015-06-14,102500,103000,500,1,500.0,-29154.0
2015-06-15,103000,104000,1000,1,1000.0,-28154.0
2015-06-16,104000,104500,500,1,500.0,-27654.0
2015-06-17,104500,104000,-500,1,-500.0,-28154.0
2015-06-18,104000,105500,1500,1,1500.0,-26654.0
2015-06-19,105500,105500,0,1,0.0,-26654.0
2015-06-20,105500,105500,0,1,0.0,-26654.0
2015-06-21,105500,107500,2000,1,2000.0,-24654.0
2015-06-22,107500,110500,3000,1,3000.0,-21654.0
2015-06-23,110500,112500,2000,1,2000.0,-19654.0
2015-06-24,112500,113500,1000,1,1000.0,-18654.0
2015-06-25,113500,111000,-2500,1,-2500.0,-21154.0
2015-06-26,111000,111000,0,1,0.0,-21154.0
2015-06-27,111000,111000,0,1,0.0,-21154.0
2015-06-28,111000,110000,-1000,1,-1000.0,-22154.0
2015-06-29,110000,109000,-1000,1,-1000.0,-23154.0
2015-06-30,109000,108500,-500,1,-500.0,-23654.0
2015-07-01,108500,110500,2000,1,2000.0,-21654.0
2015-07-02,110500,115000,4500,1,4500.0,-17154.0
2015-07-03,115000,115000,0,1,0.0,-17154.0
2015-07-04,115000,115000,0,1,0.0,-17154.0
2015-07-05,115000,109000,-6000,1,-6000.0,-23154.0
2015-07-06,109000,110000,1000,1,1000.0,-22154.0
2015-07-07,110000,107500,-2500,1,-2500.0,-24654.0
2015-07-08,107500,108000,500,1,500.0,-24154.0
2015-07-09,108000,109000,1000,1,1000.0,-23154.0
2015-07-10,109000,109000,0,1,0.0,-23154.0
2015-07-11,109000,109000,0,1,0.0,-23154.0
2015-07-12,109000,109000,0,1,0.0,-23154.0
2015-07-13,109000,107000,-2000,1,-2000.0,-25154.0
2015-07-14,107000,106500,-500,1,-500.0,-25654.0
2015-07-15,106500,107500,1000,1,1000.0,-24654.0
2015-07-16,107500,101500,-6000,1,-6000.0,-30654.0
2015-07-17,101500,101500,0,1,0.0,-30654.0
2015-07-18,101500,101500,0,1,0.0,-30654.0
2015-07-19,101500,104500,3000,1,3000.0,-27654.0
2015-07-20,104500,103500,-1000,1,-1000.0,-28654.0
2015-07-21,103500,104000,500,1,500.0,-28154.0
2015-07-22,104000,103500,-500,1,-500.0,-28654.0
2015-07-23,103500,102500,-1000,1,-1000.0,-29654.0
2015-07-24,102500,102500,0,1,0.0,-29654.0
2015-07-25,102500,102500,0,1,0.0,-29654.0
2015-07-26,102500,102000,-500,1,-500.0,-30154.0
2015-07-27,102000,101500,-500,1,-500.0,-30654.0
2015-07-28,101500,102000,500,1,500.0,-30154.0
2015-07-29,102000,101500,-500,1,-500.0,-30654.0
2015-07-30,101500,102500,1000,1,1000.0,-29654.0
2015-07-31,102500,102500,0,1,0.0,-29654.0
2015-08-01,102500,102500,0,1,0.0,-29654.0
2015-08-02,102500,101000,-1500,1,-1500.0,-31154.0
2015-08-03,101000,104500,3500,1,3500.0,-27654.0
2015-08-04,104500,102000,-2500,1,-2500.0,-30154.0
2015-08-05,102000,101500,-500,1,-500.0,-30654.0
2015-08-06,101500,97100,-4400,1,-4400.0,-35054.0
2015-08-07,97100,97100,0,1,0.0,-35054.0
2015-08-08,97100,97100,0,1,0.0,-35054.0
2015-08-09,97100,93900,-3200,1,-3200.0,-38254.0
2015-08-10,93900,92100,-1800,1,-1800.0,-40054.0
2015-08-11,92100,93700,1600,1,1600.0,-38454.0
2015-08-12,93700,96400,2700,1,2700.0,-35754.0
2015-08-13,96400,96400,0,1,0.0,-35754.0
2015-08-14,96400,96400,0,1,0.0,-35754.0
2015-08-15,96400,96400,0,1,0.0,-35754.0
2015-08-16,96400,93400,-3000,1,-3000.0,-38754.0
2015-08-17,93400,91500,-1900,1,-1900.0,-40654.0
2015-08-18,91500,98200,6700,1,6700.0,-33954.0
2015-08-19,98200,98600,400,1,400.0,-33554.0
2015-08-20,98600,97000,-1600,1,-1600.0,-35154.0
2015-08-21,97000,97000,0,1,0.0,-35154.0
2015-08-22,97000,97000,0,1,0.0,-35154.0
2015-08-23,97000,95400,-1600,1,-1600.0,-36754.0
2015-08-24,95400,93800,-1600,1,-1600.0,-38354.0
2015-08-25,93800,96200,2400,1,2400.0,-35954.0
2015-08-26,96200,95200,-1000,1,-1000.0,-36954.0
2015-08-27,95200,99500,4300,1,4300.0,-32654.0
2015-08-28,99500,99500,0,1,0.0,-32654.0
2015-08-29,99500,99500,0,1,0.0,-32654.0
2015-08-30,99500,103000,3500,1,3500.0,-29154.0
2015-08-31,103000,102500,-500,1,-500.0,-29654.0
2015-09-01,102500,101000,-1500,1,-1500.0,-31154.0
2015-09-02,101000,100000,-1000,1,-1000.0,-32154.0
2015-09-03,100000,97900,-2100,1,-2100.0,-34254.0
2015-09-04,97900,97900,0,1,0.0,-34254.0
2015-09-05,97900,97900,0,1,0.0,-34254.0
2015-09-06,97900,95300,-2600,1,-2600.0,-36854.0
2015-09-07,95300,95200,-100,1,-100.0,-36954.0
2015-09-08,95200,101500,6300,1,6300.0,-30654.0
2015-09-09,101500,107000,5500,1,5500.0,-25154.0
2015-09-10,107000,106500,-500,1,-500.0,-25654.0
2015-09-11,106500,106500,0,1,0.0,-25654.0
2015-09-12,106500,106500,0,1,0.0,-25654.0
2015-09-13,106500,106500,0,1,0.0,-25654.0
2015-09-14,106500,107000,500,1,500.0,-25154.0
2015-09-15,107000,112500,5500,1,5500.0,-19654.0
2015-09-16,112500,111500,-1000,1,-1000.0,-20654.0
2015-09-17,111500,112000,500,1,500.0,-20154.0
2015-09-18,112000,112000,0,1,0.0,-20154.0
2015-09-19,112000,112000,0,1,0.0,-20154.0
2015-09-20,112000,110500,-1500,1,-1500.0,-21654.0
2015-09-21,110500,112500,2000,1,2000.0,-19654.0
2015-09-22,112500,112500,0,1,0.0,-19654.0
2015-09-23,112500,111000,-1500,1,-1500.0,-21154.0
2015-09-24,111000,113500,2500,1,2500.0,-18654.0
2015-09-25,113500,113500,0,1,0.0,-18654.0
2015-09-26,113500,113500,0,1,0.0,-18654.0
2015-09-27,113500,113500,0,1,0.0,-18654.0
2015-09-28,113500,113500,0,1,0.0,-18654.0
2015-09-29,113500,111000,-2500,1,-2500.0,-21154.0
2015-09-30,111000,108000,-3000,1,-3000.0,-24154.0
2015-10-01,108000,107000,-1000,1,-1000.0,-25154.0
2015-10-02,107000,107000,0,1,0.0,-25154.0
2015-10-03,107000,107000,0,1,0.0,-25154.0
2015-10-04,107000,107500,500,1,500.0,-24654.0
2015-10-05,107500,108500,1000,1,1000.0,-23654.0
2015-10-06,108500,109000,500,1,500.0,-23154.0
2015-10-07,109000,105500,-3500,1,-3500.0,-26654.0
2015-10-08,105500,105500,0,1,0.0,-26654.0
2015-10-09,105500,105500,0,1,0.0,-26654.0
2015-10-10,105500,105500,0,1,0.0,-26654.0
2015-10-11,105500,109500,4000,1,4000.0,-22654.0
2015-10-12,109500,112000,2500,1,2500.0,-20154.0
2015-10-13,112000,108500,-3500,1,-3500.0,-23654.0
2015-10-14,108500,109000,500,1,500.0,-23154.0
2015-10-15,109000,101500,-7500,1,-7500.0,-30654.0
2015-10-16,101500,101500,0,1,0.0,-30654.0
2015-10-17,101500,101500,0,1,0.0,-30654.0
2015-10-18,101500,104500,3000,1,3000.0,-27654.0
2015-10-19,104500,105500,1000,1,1000.0,-26654.0
2015-10-20,105500,107500,2000,1,2000.0,-24654.0
2015-10-21,107500,105500,-2000,1,-2000.0,-26654.0
2015-10-22,105500,111000,5500,1,5500.0,-21154.0
2015-10-23,111000,111000,0,1,0.0,-21154.0
2015-10-24,111000,111000,0,1,0.0,-21154.0
2015-10-25,111000,109500,-1500,1,-1500.0,-22654.0
2015-10-26,109500,109000,-500,1,-500.0,-23154.0
2015-10-27,109000,108500,-500,1,-500.0,-23654.0
2015-10-28,108500,108000,-500,1,-500.0,-24154.0
2015-10-29,108000,110500,2500,1,2500.0,-21654.0
2015-10-30,110500,110500,0,1,0.0,-21654.0
2015-10-31,110500,110500,0,1,0.0,-21654.0
2015-11-01,110500,115500,5000,1,5000.0,-16654.0
2015-11-02,115500,114000,-1500,1,-1500.0,-18154.0
2015-11-03,114000,120000,6000,1,6000.0,-12154.0
2015-11-04,120000,121000,1000,1,1000.0,-11154.0
2015-11-05,121000,118000,-3000,1,-3000.0,-14154.0
2015-11-06,118000,118000,0,1,0.0,-14154.0
2015-11-07,118000,118000,0,1,0.0,-14154.0
2015-11-08,118000,122000,4000,1,4000.0,-10154.0
2015-11-09,122000,116500,-5500,1,-5500.0,-15654.0
2015-11-10,116500,121000,4500,1,4500.0,-11154.0
2015-11-11,121000,126000,5000,1,5000.0,-6154.0
2015-11-12,126000,123500,-2500,1,-2500.0,-8654.0
2015-11-13,123500,123500,0,1,0.0,-8654.0
2015-11-14,123500,123500,0,1,0.0,-8654.0
2015-11-15,123500,117000,-6500,1,-6500.0,-15154.0
2015-11-16,117000,112500,-4500,1,-4500.0,-19654.0
2015-11-17,112500,108500,-4000,1,-4000.0,-23654.0
2015-11-18,108500,110000,1500,1,1500.0,-22154.0
2015-11-19,110000,107500,-2500,1,-2500.0,-24654.0
2015-11-20,107500,107500,0,1,0.0,-24654.0
2015-11-21,107500,107500,0,1,0.0,-24654.0
2015-11-22,107500,111000,3500,1,3500.0,-21154.0
2015-11-23,111000,111000,0,1,0.0,-21154.0
2015-11-24,111000,107500,-3500,1,-3500.0,-24654.0
2015-11-25,107500,108500,1000,1,1000.0,-23654.0
2015-11-26,108500,107500,-1000,1,-1000.0,-24654.0
2015-11-27,107500,107500,0,1,0.0,-24654.0
2015-11-28,107500,107500,0,1,0.0,-24654.0
2015-11-29,107500,104000,-3500,1,-3500.0,-28154.0
2015-11-30,104000,104500,500,1,500.0,-27654.0
2015-12-01,104500,102500,-2000,1,-2000.0,-29654.0
2015-12-02,102500,100500,-2000,1,-2000.0,-31654.0
2015-12-03,100500,100500,0,1,0.0,-31654.0
2015-12-04,100500,100500,0,1,0.0,-31654.0
2015-12-05,100500,100500,0,1,0.0,-31654.0
2015-12-06,100500,99100,-1400,1,-1400.0,-33054.0
2015-12-07,99100,96700,-2400,1,-2400.0,-35454.0
2015-12-08,96700,100500,3800,1,3800.0,-31654.0
2015-12-09,100500,98600,-1900,1,-1900.0,-33554.0
2015-12-10,98600,97400,-1200,1,-1200.0,-34754.0
2015-12-11,97400,97400,0,1,0.0,-34754.0
2015-12-12,97400,97400,0,1,0.0,-34754.0
2015-12-13,97400,93500,-3900,1,-3900.0,-38654.0
2015-12-14,93500,93900,400,1,400.0,-38254.0
2015-12-15,93900,98700,4800,1,4800.0,-33454.0
2015-12-16,98700,97300,-1400,1,-1400.0,-34854.0
2015-12-17,97300,96900,-400,1,-400.0,-35254.0
2015-12-18,96900,96900,0,1,0.0,-35254.0
2015-12-19,96900,96900,0,1,0.0,-35254.0
2015-12-20,96900,98700,1800,1,1800.0,-33454.0
2015-12-21,98700,95800,-2900,1,-2900.0,-36354.0
2015-12-22,95800,95100,-700,1,-700.0,-37054.0
2015-12-23,95100,95700,600,1,600.0,-36454.0
2015-12-24,95700,95700,0,1,0.0,-36454.0
2015-12-25,95700,95700,0,1,0.0,-36454.0
2015-12-26,95700,95700,0,1,0.0,-36454.0
2015-12-27,95700,93600,-2100,1,-2100.0,-38554.0
2015-12-28,93600,90900,-2700,1,-2700.0,-41254.0
2015-12-29,90900,88500,-2400,1,-2400.0,-43654.0
2015-12-30,88500,88500,0,1,0.0,-43654.0
2015-12-31,88500,88500,0,1,0.0,-43654.0
2016-01-01,88500,88500,0,1,0.0,-43654.0
2016-01-02,88500,88500,0,1,0.0,-43654.0
2016-01-03,88500,82600,-5900,1,-5900.0,-49554.0
2016-01-04,82600,83000,400,1,400.0,-49154.0
2016-01-05,83000,82900,-100,1,-100.0,-49254.0
2016-01-06,82900,81900,-1000,1,-1000.0,-50254.0
2016-01-07,81900,80900,-1000,1,-1000.0,-51254.0
2016-01-08,80900,80900,0,1,0.0,-51254.0
2016-01-09,80900,80900,0,1,0.0,-51254.0
2016-01-10,80900,80500,-400,1,-400.0,-51654.0
2016-01-11,80500,79800,-700,1,-700.0,-52354.0
2016-01-12,79800,79500,-300,1,-300.0,-52654.0
2016-01-13,79500,76500,-3000,1,-3000.0,-55654.0
2016-01-14,76500,70400,-6100,1,-6100.0,-61754.0
2016-01-15,70400,70400,0,1,0.0,-61754.0
2016-01-16,70400,70400,0,1,0.0,-61754.0
2016-01-17,70400,74200,3800,1,3800.0,-57954.0
2016-01-18,74200,71900,-2300,1,-2300.0,-60254.0
2016-01-19,71900,70200,-1700,1,-1700.0,-61954.0
2016-01-20,70200,72700,2500,1,2500.0,-59454.0
2016-01-21,72700,74100,1400,1,1400.0,-58054.0
2016-01-22,74100,74100,0,1,0.0,-58054.0
2016-01-23,74100,74100,0,1,0.0,-58054.0
2016-01-24,74100,75200,1100,1,1100.0,-56954.0
2016-01-25,75200,74400,-800,1,-800.0,-57754.0
2016-01-26,74400,75900,1500,1,1500.0,-56254.0
2016-01-27,75900,77500,1600,1,1600.0,-54654.0
2016-01-28,77500,76600,-900,1,-900.0,-55554.0
2016-01-29,76600,76600,0,1,0.0,-55554.0
2016-01-30,76600,76600,0,1,0.0,-55554.0
2016-01-31,76600,76300,-300,1,-300.0,-55854.0
2016-02-01,76300,75000,-1300,1,-1300.0,-57154.0
2016-02-02,75000,72400,-2600,1,-2600.0,-59754.0
2016-02-03,72400,73500,1100,1,1100.0,-58654.0
2016-02-04,73500,77200,3700,1,3700.0,-54954.0
2016-02-05,77200,77200,0,1,0.0,-54954.0
2016-02-06,77200,77200,0,1,0.0,-54954.0
2016-02-07,77200,77200,0,1,0.0,-54954.0
2016-02-08,77200,77200,0,1,0.0,-54954.0
2016-02-09,77200,77200,0,1,0.0,-54954.0
2016-02-10,77200,73900,-3300,1,-3300.0,-58254.0
2016-02-11,73900,72000,-1900,1,-1900.0,-60154.0
2016-02-12,72000,72000,0,1,0.0,-60154.0
2016-02-13,72000,72000,0,1,0.0,-60154.0
2016-02-14,72000,74600,2600,1,2600.0,-57554.0
2016-02-15,74600,76000,1400,1,1400.0,-56154.0
2016-02-16,76000,75400,-600,1,-600.0,-56754.0
2016-02-17,75400,77900,2500,1,2500.0,-54254.0
2016-02-18,77900,77900,0,1,0.0,-54254.0
2016-02-19,77900,77900,0,1,0.0,-54254.0
2016-02-20,77900,77900,0,1,0.0,-54254.0
2016-02-21,77900,75600,-2300,1,-2300.0,-56554.0
2016-02-22,75600,76100,500,1,500.0,-56054.0
2016-02-23,76100,76400,300,1,300.0,-55754.0
2016-02-24,76400,75400,-1000,1,-1000.0,-56754.0
2016-02-25,75400,74800,-600,1,-600.0,-57354.0
2016-02-26,74800,74800,0,1,0.0,-57354.0
2016-02-27,74800,74800,0,1,0.0,-57354.0
2016-02-28,74800,75400,600,1,600.0,-56754.0
2016-02-29,75400,75400,0,1,0.0,-56754.0
2016-03-01,75400,81300,5900,1,5900.0,-50854.0
2016-03-02,81300,83800,2500,1,2500.0,-48354.0
2016-03-03,83800,84700,900,1,900.0,-47454.0
2016-03-04,84700,84700,0,1,0.0,-47454.0
2016-03-05,84700,84700,0,1,0.0,-47454.0
2016-03-06,84700,87800,3100,1,3100.0,-44354.0
2016-03-07,87800,87700,-100,1,-100.0,-44454.0
2016-03-08,87700,87000,-700,1,-700.0,-45154.0
2016-03-09,87000,89000,2000,1,2000.0,-43154.0
2016-03-10,89000,90300,1300,1,1300.0,-41854.0
2016-03-11,90300,90300,0,1,0.0,-41854.0
2016-03-12,90300,90300,0,1,0.0,-41854.0
2016-03-13,90300,88600,-1700,1,-1700.0,-43554.0
2016-03-14,88600,86600,-2000,1,-2000.0,-45554.0
2016-03-15,86600,84600,-2000,1,-2000.0,-47554.0
2016-03-16,84600,86400,1800,1,1800.0,-45754.0
2016-03-17,86400,86300,-100,1,-100.0,-45854.0
2016-03-18,86300,86300,0,1,0.0,-45854.0
2016-03-19,86300,86300,0,1,0.0,-45854.0
2016-03-20,86300,85900,-400,1,-400.0,-46254.0
2016-03-21,85900,87100,1200,1,1200.0,-45054.0
2016-03-22,87100,86700,-400,1,-400.0,-45454.0
2016-03-23,86700,84000,-2700,1,-2700.0,-48154.0
2016-03-24,84000,83300,-700,1,-700.0,-48854.0
2016-03-25,83300,83300,0,1,0.0,-48854.0
2016-03-26,83300,83300,0,1,0.0,-48854.0
2016-03-27,83300,82500,-800,1,-800.0,-49654.0
2016-03-28,82500,84900,2400,1,2400.0,-47254.0
2016-03-29,84900,86000,1100,1,1100.0,-46154.0
2016-03-30,86000,88400,2400,1,2400.0,-43754.0
2016-03-31,88400,85700,-2700,1,-2700.0,-46454.0
2016-04-01,85700,85700,0,1,0.0,-46454.0
2016-04-02,85700,85700,0,1,0.0,-46454.0
2016-04-03,85700,84000,-1700,1,-1700.0,-48154.0
2016-04-04,84000,82100,-1900,1,-1900.0,-50054.0
2016-04-05,82100,81600,-500,1,-500.0,-50554.0
2016-04-06,81600,83600,2000,1,2000.0,-48554.0
2016-04-07,83600,87900,4300,1,4300.0,-44254.0
2016-04-08,87900,87900,0,1,0.0,-44254.0
2016-04-09,87900,87900,0,1,0.0,-44254.0
2016-04-10,87900,97200,9300,1,9300.0,-34954.0
2016-04-11,97200,97800,600,1,600.0,-34354.0
2016-04-12,97800,97800,0,1,0.0,-34354.0
2016-04-13,97800,104500,6700,1,6700.0,-27654.0
2016-04-14,104500,104500,0,1,0.0,-27654.0
2016-04-15,104500,104500,0,1,0.0,-27654.0
2016-04-16,104500,104500,0,1,0.0,-27654.0
2016-04-17,104500,102000,-2500,1,-2500.0,-30154.0
2016-04-18,102000,105000,3000,1,3000.0,-27154.0
2016-04-19,105000,106500,1500,1,1500.0,-25654.0
2016-04-20,106500,107500,1000,1,1000.0,-24654.0
2016-04-21,107500,107500,0,1,0.0,-24654.0
2016-04-22,107500,107500,0,1,0.0,-24654.0
2016-04-23,107500,107500,0,1,0.0,-24654.0
2016-04-24,107500,108000,500,1,500.0,-24154.0
2016-04-25,108000,103500,-4500,1,-4500.0,-28654.0
2016-04-26,103500,108500,5000,1,5000.0,-23654.0
2016-04-27,108500,108000,-500,1,-500.0,-24154.0
2016-04-28,108000,107500,-500,1,-500.0,-24654.0
2016-04-29,107500,107500,0,1,0.0,-24654.0
2016-04-30,107500,107500,0,1,0.0,-24654.0
2016-05-01,107500,106000,-1500,1,-1500.0,-26154.0
2016-05-02,106000,104000,-2000,1,-2000.0,-28154.0
2016-05-03,104000,102500,-1500,1,-1500.0,-29654.0
2016-05-04,102500,102500,0,1,0.0,-29654.0
2016-05-05,102500,102500,0,1,0.0,-29654.0
2016-05-06,102500,102500,0,1,0.0,-29654.0
2016-05-07,102500,102500,0,1,0.0,-29654.0
2016-05-08,102500,99500,-3000,1,-3000.0,-32654.0
2016-05-09,99500,106500,7000,1,7000.0,-25654.0
2016-05-10,106500,103000,-3500,1,-3500.0,-29154.0
2016-05-11,103000,104000,1000,1,1000.0,-28154.0
2016-05-12,104000,97200,-6800,1,-6800.0,-34954.0
2016-05-13,97200,97200,0,1,0.0,-34954.0
2016-05-14,97200,97200,0,1,0.0,-34954.0
2016-05-15,97200,96800,-400,1,-400.0,-35354.0
2016-05-16,96800,95600,-1200,1,-1200.0,-36554.0
2016-05-17,95600,94400,-1200,1,-1200.0,-37754.0
2016-05-18,94400,93600,-800,1,-800.0,-38554.0
2016-05-19,93600,92500,-1100,1,-1100.0,-39654.0
2016-05-20,92500,92500,0,1,0.0,-39654.0
2016-05-21,92500,92500,0,1,0.0,-39654.0
2016-05-22,92500,95000,2500,1,2500.0,-37154.0
2016-05-23,95000,91600,-3400,1,-3400.0,-40554.0
2016-05-24,91600,92400,800,1,800.0,-39754.0
2016-05-25,92400,93900,1500,1,1500.0,-38254.0
2016-05-26,93900,95500,1600,1,1600.0,-36654.0
2016-05-27,95500,95500,0,1,0.0,-36654.0
2016-05-28,95500,95500,0,1,0.0,-36654.0
2016-05-29,95500,94500,-1000,1,-1000.0,-37654.0
2016-05-30,94500,97000,2500,1,2500.0,-35154.0
2016-05-31,97000,95300,-1700,1,-1700.0,-36854.0
2016-06-01,95300,94000,-1300,1,-1300.0,-38154.0
2016-06-02,94000,96800,2800,1,2800.0,-35354.0
2016-06-03,96800,96800,0,1,0.0,-35354.0
2016-06-04,96800,96800,0,1,0.0,-35354.0
2016-06-05,96800,96800,0,1,0.0,-35354.0
2016-06-06,96800,95700,-1100,1,-1100.0,-36454.0
2016-06-07,95700,96100,400,1,400.0,-36054.0
2016-06-08,96100,98200,2100,1,2100.0,-33954.0
2016-06-09,98200,97000,-1200,1,-1200.0,-35154.0
2016-06-10,97000,97000,0,1,0.0,-35154.0
2016-06-11,97000,97000,0,1,0.0,-35154.0
2016-06-12,97000,93700,-3300,1,-3300.0,-38454.0
2016-06-13,93700,95800,2100,1,2100.0,-36354.0
2016-06-14,95800,95600,-200,1,-200.0,-36554.0
2016-06-15,95600,93300,-2300,1,-2300.0,-38854.0
2016-06-16,93300,93400,100,1,100.0,-38754.0
2016-06-17,93400,93400,0,1,0.0,-38754.0
2016-06-18,93400,93400,0,1,0.0,-38754.0
2016-06-19,93400,94700,1300,1,1300.0,-37454.0
2016-06-20,94700,93900,-800,1,-800.0,-38254.0
2016-06-21,93900,93700,-200,1,-200.0,-38454.0
2016-06-22,93700,91500,-2200,1,-2200.0,-40654.0
2016-06-23,91500,89900,-1600,1,-1600.0,-42254.0
2016-06-24,89900,89900,0,1,0.0,-42254.0
2016-06-25,89900,89900,0,1,0.0,-42254.0
2016-06-26,89900,89900,0,1,0.0,-42254.0
2016-06-27,89900,90500,600,1,600.0,-41654.0
2016-06-28,90500,92300,1800,1,1800.0,-39854.0
2016-06-29,92300,93200,900,1,900.0,-38954.0
2016-06-30,93200,94400,1200,1,1200.0,-37754.0
2016-07-01,94400,94400,0,1,0.0,-37754.0
2016-07-02,94400,94400,0,1,0.0,-37754.0
2016-07-03,94400,94900,500,1,500.0,-37254.0
2016-07-04,94900,94100,-800,1,-800.0,-38054.0
2016-07-05,94100,92700,-1400,1,-1400.0,-39454.0
2016-07-06,92700,94100,1400,1,1400.0,-38054.0
2016-07-07,94100,93900,-200,1,-200.0,-38254.0
2016-07-08,93900,93900,0,1,0.0,-38254.0
2016-07-09,93900,93900,0,1,0.0,-38254.0
2016-07-10,93900,98000,4100,1,4100.0,-34154.0
2016-07-11,98000,99700,1700,1,1700.0,-32454.0
2016-07-12,99700,100000,300,1,300.0,-32154.0
2016-07-13,100000,98800,-1200,1,-1200.0,-33354.0
2016-07-14,98800,103000,4200,1,4200.0,-29154.0
2016-07-15,103000,103000,0,1,0.0,-29154.0
2016-07-16,103000,103000,0,1,0.0,-29154.0
2016-07-17,103000,105000,2000,1,2000.0,-27154.0
2016-07-18,105000,104000,-1000,1,-1000.0,-28154.0
2016-07-19,104000,106500,2500,1,2500.0,-25654.0
2016-07-20,106500,106000,-500,1,-500.0,-26154.0
2016-07-21,106000,105000,-1000,1,-1000.0,-27154.0
2016-07-22,105000,105000,0,1,0.0,-27154.0
2016-07-23,105000,105000,0,1,0.0,-27154.0
2016-07-24,105000,106000,1000,1,1000.0,-26154.0
2016-07-25,106000,113000,7000,1,7000.0,-19154.0
2016-07-26,113000,113500,500,1,500.0,-18654.0
2016-07-27,113500,113500,0,1,0.0,-18654.0
2016-07-28,113500,112500,-1000,1,-1000.0,-19654.0
2016-07-29,112500,112500,0,1,0.0,-19654.0
2016-07-30,112500,112500,0,1,0.0,-19654.0
2016-07-31,112500,112500,0,1,0.0,-19654.0
2016-08-01,112500,109500,-3000,1,-3000.0,-22654.0
2016-08-02,109500,107000,-2500,1,-2500.0,-25154.0
2016-08-03,107000,107000,0,1,0.0,-25154.0
2016-08-04,107000,113000,6000,1,6000.0,-19154.0
2016-08-05,113000,113000,0,1,0.0,-19154.0
2016-08-06,113000,113000,0,1,0.0,-19154.0
2016-08-07,113000,110500,-2500,1,-2500.0,-21654.0
2016-08-08,110500,114000,3500,1,3500.0,-18154.0
2016-08-09,114000,113000,-1000,1,-1000.0,-19154.0
2016-08-10,113000,113500,500,1,500.0,-18654.0
2016-08-11,113500,115000,1500,1,1500.0,-17154.0
2016-08-12,115000,115000,0,1,0.0,-17154.0
2016-08-13,115000,115000,0,1,0.0,-17154.0
2016-08-14,115000,115000,0,1,0.0,-17154.0
2016-08-15,115000,111500,-3500,1,-3500.0,-20654.0
2016-08-16,111500,114000,2500,1,2500.0,-18154.0
2016-08-17,114000,117000,3000,1,3000.0,-15154.0
2016-08-18,117000,118500,1500,1,1500.0,-13654.0
2016-08-19,118500,118500,0,1,0.0,-13654.0
2016-08-20,118500,118500,0,1,0.0,-13654.0
2016-08-21,118500,113000,-5500,1,-5500.0,-19154.0
2016-08-22,113000,117000,4000,1,4000.0,-15154.0
2016-08-23,117000,119000,2000,1,2000.0,-13154.0
2016-08-24,119000,119500,500,1,500.0,-12654.0
2016-08-25,119500,118000,-1500,1,-1500.0,-14154.0
2016-08-26,118000,118000,0,1,0.0,-14154.0
2016-08-27,118000,118000,0,1,0.0,-14154.0
2016-08-28,118000,113500,-4500,1,-4500.0,-18654.0
2016-08-29,113500,117000,3500,1,3500.0,-15154.0
2016-08-30,117000,118500,1500,1,1500.0,-13654.0
2016-08-31,118500,117000,-1500,1,-1500.0,-15154.0
2016-09-01,117000,117500,500,1,500.0,-14654.0
2016-09-02,117500,117500,0,1,0.0,-14654.0
2016-09-03,117500,117500,0,1,0.0,-14654.0
2016-09-04,117500,119500,2000,1,2000.0,-12654.0
2016-09-05,119500,115500,-4000,1,-4000.0,-16654.0
2016-09-06,115500,114000,-1500,1,-1500.0,-18154.0
2016-09-07,114000,114000,0,1,0.0,-18154.0
2016-09-08,114000,113000,-1000,1,-1000.0,-19154.0
2016-09-09,113000,113000,0,1,0.0,-19154.0
2016-09-10,113000,113000,0,1,0.0,-19154.0
2016-09-11,113000,111000,-2000,1,-2000.0,-21154.0
2016-09-12,111000,109500,-1500,1,-1500.0,-22654.0
2016-09-13,109500,109500,0,1,0.0,-22654.0
2016-09-14,109500,109500,0,1,0.0,-22654.0
2016-09-15,109500,109500,0,1,0.0,-22654.0
2016-09-16,109500,109500,0,1,0.0,-22654.0
2016-09-17,109500,109500,0,1,0.0,-22654.0
2016-09-18,109500,109000,-500,1,-500.0,-23154.0
2016-09-19,109000,108500,-500,1,-500.0,-23654.0
2016-09-20,108500,107000,-1500,1,-1500.0,-25154.0
2016-09-21,107000,106000,-1000,1,-1000.0,-26154.0
2016-09-22,106000,105000,-1000,1,-1000.0,-27154.0
2016-09-23,105000,105000,0,1,0.0,-27154.0
2016-09-24,105000,105000,0,1,0.0,-27154.0
2016-09-25,105000,106000,1000,1,1000.0,-26154.0
2016-09-26,106000,106000,0,1,0.0,-26154.0
2016-09-27,106000,102000,-4000,1,-4000.0,-30154.0
2016-09-28,102000,103000,1000,1,1000.0,-29154.0
2016-09-29,103000,101000,-2000,1,-2000.0,-31154.0
2016-09-30,101000,101000,0,1,0.0,-31154.0
2016-10-01,101000,101000,0,1,0.0,-31154.0
2016-10-02,101000,101000,0,1,0.0,-31154.0
2016-10-03,101000,103500,2500,1,2500.0,-28654.0
2016-10-04,103500,102500,-1000,1,-1000.0,-29654.0
2016-10-05,102500,106000,3500,1,3500.0,-26154.0
2016-10-06,106000,100500,-5500,1,-5500.0,-31654.0
2016-10-07,100500,100500,0,1,0.0,-31654.0
2016-10-08,100500,100500,0,1,0.0,-31654.0
2016-10-09,100500,97200,-3300,1,-3300.0,-34954.0
2016-10-10,97200,96200,-1000,1,-1000.0,-35954.0
2016-10-11,96200,99600,3400,1,3400.0,-32554.0
2016-10-12,99600,99200,-400,1,-400.0,-32954.0
2016-10-13,99200,100000,800,1,800.0,-32154.0
2016-10-14,100000,100000,0,1,0.0,-32154.0
2016-10-15,100000,100000,0,1,0.0,-32154.0
2016-10-16,100000,101000,1000,1,1000.0,-31154.0
2016-10-17,101000,101500,500,1,500.0,-30654.0
2016-10-18,101500,100000,-1500,1,-1500.0,-32154.0
2016-10-19,100000,100500,500,1,500.0,-31654.0
2016-10-20,100500,102000,1500,1,1500.0,-30154.0
2016-10-21,102000,102000,0,1,0.0,-30154.0
2016-10-22,102000,102000,0,1,0.0,-30154.0
2016-10-23,102000,104000,2000,1,2000.0,-28154.0
2016-10-24,104000,102000,-2000,1,-2000.0,-30154.0
2016-10-25,102000,102500,500,1,500.0,-29654.0
2016-10-26,102500,104000,1500,1,1500.0,-28154.0
2016-10-27,104000,103000,-1000,1,-1000.0,-29154.0
2016-10-28,103000,103000,0,1,0.0,-29154.0
2016-10-29,103000,103000,0,1,0.0,-29154.0
2016-10-30,103000,102500,-500,1,-500.0,-29654.0
2016-10-31,102500,103000,500,1,500.0,-29154.0
2016-11-01,103000,102000,-1000,1,-1000.0,-30154.0
2016-11-02,102000,101500,-500,1,-500.0,-30654.0
2016-11-03,101500,101500,0,1,0.0,-30654.0
2016-11-04,101500,101500,0,1,0.0,-30654.0
2016-11-05,101500,101500,0,1,0.0,-30654.0
2016-11-06,101500,104000,2500,1,2500.0,-28154.0
2016-11-07,104000,103500,-500,1,-500.0,-28654.0
2016-11-08,103500,99500,-4000,1,-4000.0,-32654.0
2016-11-09,99500,107000,7500,1,7500.0,-25154.0
2016-11-10,107000,114000,7000,1,7000.0,-18154.0
2016-11-11,114000,114000,0,1,0.0,-18154.0
2016-11-12,114000,114000,0,1,0.0,-18154.0
2016-11-13,114000,114500,500,1,500.0,-17654.0
2016-11-14,114500,111500,-3000,1,-3000.0,-20654.0
2016-11-15,111500,114000,2500,1,2500.0,-18154.0
2016-11-16,114000,113000,-1000,1,-1000.0,-19154.0
2016-11-17,113000,109500,-3500,1,-3500.0,-22654.0
2016-11-18,109500,109500,0,1,0.0,-22654.0
2016-11-19,109500,109500,0,1,0.0,-22654.0
2016-11-20,109500,111000,1500,1,1500.0,-21154.0
2016-11-21,111000,112000,1000,1,1000.0,-20154.0
2016-11-22,112000,109000,-3000,1,-3000.0,-23154.0
2016-11-23,109000,108500,-500,1,-500.0,-23654.0
2016-11-24,108500,109000,500,1,500.0,-23154.0
2016-11-25,109000,109000,0,1,0.0,-23154.0
2016-11-26,109000,109000,0,1,0.0,-23154.0
2016-11-27,109000,109000,0,1,0.0,-23154.0
2016-11-28,109000,109500,500,1,500.0,-22654.0
2016-11-29,109500,110500,1000,1,1000.0,-21654.0
2016-11-30,110500,110000,-500,1,-500.0,-22154.0
2016-12-01,110000,108000,-2000,1,-2000.0,-24154.0
2016-12-02,108000,108000,0,1,0.0,-24154.0
2016-12-03,108000,108000,0,1,0.0,-24154.0
2016-12-04,108000,110500,2500,1,2500.0,-21654.0
2016-12-05,110500,110000,-500,1,-500.0,-22154.0
2016-12-06,110000,109000,-1000,1,-1000.0,-23154.0
2016-12-07,109000,108000,-1000,1,-1000.0,-24154.0
2016-12-08,108000,108000,0,1,0.0,-24154.0
2016-12-09,108000,108000,0,1,0.0,-24154.0
2016-12-10,108000,108000,0,1,0.0,-24154.0
2016-12-11,108000,110500,2500,1,2500.0,-21654.0
2016-12-12,110500,107500,-3000,1,-3000.0,-24654.0
2016-12-13,107500,109500,2000,1,2000.0,-22654.0
2016-12-14,109500,110500,1000,1,1000.0,-21654.0
2016-12-15,110500,112500,2000,1,2000.0,-19654.0
2016-12-16,112500,112500,0,1,0.0,-19654.0
2016-12-17,112500,112500,0,1,0.0,-19654.0
2016-12-18,112500,110500,-2000,1,-2000.0,-21654.0
2016-12-19,110500,111500,1000,1,1000.0,-20654.0
2016-12-20,111500,110500,-1000,1,-1000.0,-21654.0
2016-12-21,110500,110500,0,1,0.0,-21654.0
2016-12-22,110500,111000,500,1,500.0,-21154.0
2016-12-23,111000,111000,0,1,0.0,-21154.0
2016-12-24,111000,111000,0,1,0.0,-21154.0
2016-12-25,111000,114500,3500,1,3500.0,-17654.0
2016-12-26,114500,115000,500,1,500.0,-17154.0
2016-12-27,115000,109000,-6000,1,-6000.0,-23154.0
2016-12-28,109000,105000,-4000,1,-4000.0,-27154.0
2016-12-29,105000,105000,0,1,0.0,-27154.0
2016-12-30,105000,105000,0,1,0.0,-27154.0
2016-12-31,105000,105000,0,1,0.0,-27154.0
2017-01-01,105000,106500,1500,1,1500.0,-25654.0
2017-01-02,106500,107000,500,1,500.0,-25154.0
2017-01-03,107000,104000,-3000,1,-3000.0,-28154.0
2017-01-04,104000,105500,1500,1,1500.0,-26654.0
2017-01-05,105500,106500,1000,1,1000.0,-25654.0
2017-01-06,106500,106500,0,1,0.0,-25654.0
2017-01-07,106500,106500,0,1,0.0,-25654.0
2017-01-08,106500,106500,0,1,0.0,-25654.0
2017-01-09,106500,106000,-500,1,-500.0,-26154.0
2017-01-10,106000,108500,2500,1,2500.0,-23654.0
2017-01-11,108500,108000,-500,1,-500.0,-24154.0
2017-01-12,108000,107500,-500,1,-500.0,-24654.0
2017-01-13,107500,107500,0,1,0.0,-24654.0
2017-01-14,107500,107500,0,1,0.0,-24654.0
2017-01-15,107500,107000,-500,1,-500.0,-25154.0
2017-01-16,107000,107500,500,1,500.0,-24654.0
2017-01-17,107500,107500,0,1,0.0,-24654.0
2017-01-18,107500,107000,-500,1,-500.0,-25154.0
2017-01-19,107000,106500,-500,1,-500.0,-25654.0
2017-01-20,106500,106500,0,1,0.0,-25654.0
2017-01-21,106500,106500,0,1,0.0,-25654.0
2017-01-22,106500,106500,0,1,0.0,-25654.0
2017-01-23,106500,106000,-500,1,-500.0,-26154.0
2017-01-24,106000,102000,-4000,1,-4000.0,-30154.0
2017-01-25,102000,103500,1500,1,1500.0,-28654.0
2017-01-26,103500,103500,0,1,0.0,-28654.0
2017-01-27,103500,103500,0,1,0.0,-28654.0
2017-01-28,103500,103500,0,1,0.0,-28654.0
2017-01-29,103500,103500,0,1,0.0,-28654.0
2017-01-30,103500,105000,1500,1,1500.0,-27154.0
2017-01-31,105000,106500,1500,1,1500.0,-25654.0
2017-02-01,106500,108000,1500,1,1500.0,-24154.0
2017-02-02,108000,106500,-1500,1,-1500.0,-25654.0
2017-02-03,106500,106500,0,1,0.0,-25654.0
2017-02-04,106500,106500,0,1,0.0,-25654.0
2017-02-05,106500,108000,1500,1,1500.0,-24154.0
2017-02-06,108000,104500,-3500,1,-3500.0,-27654.0
2017-02-07,104500,105000,500,1,500.0,-27154.0
2017-02-08,105000,108000,3000,1,3000.0,-24154.0
2017-02-09,108000,109000,1000,1,1000.0,-23154.0
2017-02-10,109000,109000,0,1,0.0,-23154.0
2017-02-11,109000,109000,0,1,0.0,-23154.0
2017-02-12,109000,109000,0,1,0.0,-23154.0
2017-02-13,109000,109500,500,1,500.0,-22654.0
2017-02-14,109500,109000,-500,1,-500.0,-23154.0
2017-02-15,109000,105000,-4000,1,-4000.0,-27154.0
2017-02-16,105000,105000,0,1,0.0,-27154.0
2017-02-17,105000,105000,0,1,0.0,-27154.0
2017-02-18,105000,105000,0,1,0.0,-27154.0
2017-02-19,105000,104000,-1000,1,-1000.0,-28154.0
2017-02-20,104000,104500,500,1,500.0,-27654.0
2017-02-21,104500,103000,-1500,1,-1500.0,-29154.0
2017-02-22,103000,102000,-1000,1,-1000.0,-30154.0
2017-02-23,102000,100000,-2000,1,-2000.0,-32154.0
2017-02-24,100000,100000,0,1,0.0,-32154.0
2017-02-25,100000,100000,0,1,0.0,-32154.0
2017-02-26,100000,101000,1000,1,1000.0,-31154.0
2017-02-27,101000,95700,-5300,1,-5300.0,-36454.0
2017-02-28,95700,95700,0,1,0.0,-36454.0
2017-03-01,95700,97700,2000,1,2000.0,-34454.0
2017-03-02,97700,97300,-400,1,-400.0,-34854.0
2017-03-03,97300,97300,0,1,0.0,-34854.0
2017-03-04,97300,97300,0,1,0.0,-34854.0
2017-03-05,97300,96500,-800,1,-800.0,-35654.0
2017-03-06,96500,99500,3000,1,3000.0,-32654.0
2017-03-07,99500,96300,-3200,1,-3200.0,-35854.0
2017-03-08,96300,95000,-1300,1,-1300.0,-37154.0
2017-03-09,95000,94000,-1000,1,-1000.0,-38154.0
2017-03-10,94000,94000,0,1,0.0,-38154.0
2017-03-11,94000,94000,0,1,0.0,-38154.0
2017-03-12,94000,94200,200,1,200.0,-37954.0
2017-03-13,94200,93700,-500,1,-500.0,-38454.0
2017-03-14,93700,93400,-300,1,-300.0,-38754.0
2017-03-15,93400,97000,3600,1,3600.0,-35154.0
2017-03-16,97000,96300,-700,1,-700.0,-35854.0
2017-03-17,96300,96300,0,1,0.0,-35854.0
2017-03-18,96300,96300,0,1,0.0,-35854.0
2017-03-19,96300,96500,200,1,200.0,-35654.0
2017-03-20,96500,96100,-400,1,-400.0,-36054.0
2017-03-21,96100,95100,-1000,1,-1000.0,-37054.0
2017-03-22,95100,97200,2100,1,2100.0,-34954.0
2017-03-23,97200,96600,-600,1,-600.0,-35554.0
2017-03-24,96600,96600,0,1,0.0,-35554.0
2017-03-25,96600,96600,0,1,0.0,-35554.0
2017-03-26,96600,94000,-2600,1,-2600.0,-38154.0
2017-03-27,94000,94000,0,1,0.0,-38154.0
2017-03-28,94000,94100,100,1,100.0,-38054.0
2017-03-29,94100,94400,300,1,300.0,-37754.0
2017-03-30,94400,94700,300,1,300.0,-37454.0
2017-03-31,94700,94700,0,1,0.0,-37454.0
2017-04-01,94700,94700,0,1,0.0,-37454.0
2017-04-02,94700,94400,-300,1,-300.0,-37754.0
2017-04-03,94400,94100,-300,1,-300.0,-38054.0
2017-04-04,94100,95300,1200,1,1200.0,-36854.0
2017-04-05,95300,96800,1500,1,1500.0,-35354.0
2017-04-06,96800,98100,1300,1,1300.0,-34054.0
2017-04-07,98100,98100,0,1,0.0,-34054.0
2017-04-08,98100,98100,0,1,0.0,-34054.0
2017-04-09,98100,96200,-1900,1,-1900.0,-35954.0
2017-04-10,96200,95500,-700,1,-700.0,-36654.0
2017-04-11,95500,95500,0,1,0.0,-36654.0
2017-04-12,95500,95900,400,1,400.0,-36254.0
2017-04-13,95900,94600,-1300,1,-1300.0,-37554.0
2017-04-14,94600,94600,0,1,0.0,-37554.0
2017-04-15,94600,94600,0,1,0.0,-37554.0
2017-04-16,94600,94900,300,1,300.0,-37254.0
2017-04-17,94900,95300,400,1,400.0,-36854.0
2017-04-18,95300,94800,-500,1,-500.0,-37354.0
2017-04-19,94800,95600,800,1,800.0,-36554.0
2017-04-20,95600,95900,300,1,300.0,-36254.0
2017-04-21,95900,95900,0,1,0.0,-36254.0
2017-04-22,95900,95900,0,1,0.0,-36254.0
2017-04-23,95900,95900,0,1,0.0,-36254.0
2017-04-24,95900,96800,900,1,900.0,-35354.0
2017-04-25,96800,98800,2000,1,2000.0,-33354.0
2017-04-26,98800,98000,-800,1,-800.0,-34154.0
2017-04-27,98000,97300,-700,1,-700.0,-34854.0
2017-04-28,97300,97300,0,1,0.0,-34854.0
2017-04-29,97300,97300,0,1,0.0,-34854.0
2017-04-30,97300,97300,0,1,0.0,-34854.0
2017-05-01,97300,97200,-100,1,-100.0,-34954.0
2017-05-02,97200,97200,0,1,0.0,-34954.0
2017-05-03,97200,98800,1600,1,1600.0,-33354.0
2017-05-04,98800,98800,0,1,0.0,-33354.0
2017-05-05,98800,98800,0,1,0.0,-33354.0
2017-05-06,98800,98800,0,1,0.0,-33354.0
2017-05-07,98800,99500,700,1,700.0,-32654.0
2017-05-08,99500,99500,0,1,0.0,-32654.0
2017-05-09,99500,99200,-300,1,-300.0,-32954.0
2017-05-10,99200,102000,2800,1,2800.0,-30154.0
2017-05-11,102000,101000,-1000,1,-1000.0,-31154.0
2017-05-12,101000,101000,0,1,0.0,-31154.0
2017-05-13,101000,101000,0,1,0.0,-31154.0
2017-05-14,101000,102500,1500,1,1500.0,-29654.0
2017-05-15,102500,102500,0,1,0.0,-29654.0
2017-05-16,102500,104500,2000,1,2000.0,-27654.0
2017-05-17,104500,105000,500,1,500.0,-27154.0
2017-05-18,105000,107500,2500,1,2500.0,-24654.0
2017-05-19,107500,107500,0,1,0.0,-24654.0
2017-05-20,107500,107500,0,1,0.0,-24654.0
2017-05-21,107500,107000,-500,1,-500.0,-25154.0
2017-05-22,107000,112000,5000,1,5000.0,-20154.0
2017-05-23,112000,114000,2000,1,2000.0,-18154.0
2017-05-24,114000,115000,1000,1,1000.0,-17154.0
2017-05-25,115000,116000,1000,1,1000.0,-16154.0
2017-05-26,116000,116000,0,1,0.0,-16154.0
2017-05-27,116000,116000,0,1,0.0,-16154.0
2017-05-28,116000,118000,2000,1,2000.0,-14154.0
2017-05-29,118000,117500,-500,1,-500.0,-14654.0
2017-05-30,117500,117500,0,1,0.0,-14654.0
2017-05-31,117500,115000,-2500,1,-2500.0,-17154.0
2017-06-01,115000,114500,-500,1,-500.0,-17654.0
2017-06-02,114500,114500,0,1,0.0,-17654.0
2017-06-03,114500,114500,0,1,0.0,-17654.0
2017-06-04,114500,113500,-1000,1,-1000.0,-18654.0
2017-06-05,113500,113500,0,1,0.0,-18654.0
2017-06-06,113500,112500,-1000,1,-1000.0,-19654.0
2017-06-07,112500,112500,0,1,0.0,-19654.0
2017-06-08,112500,124500,12000,1,12000.0,-7654.0
2017-06-09,124500,124500,0,1,0.0,-7654.0
2017-06-10,124500,124500,0,1,0.0,-7654.0
2017-06-11,124500,122000,-2500,1,-2500.0,-10154.0
2017-06-12,122000,125500,3500,1,3500.0,-6654.0
2017-06-13,125500,126000,500,1,500.0,-6154.0
2017-06-14,126000,121500,-4500,1,-4500.0,-10654.0
2017-06-15,121500,121000,-500,1,-500.0,-11154.0
2017-06-16,121000,121000,0,1,0.0,-11154.0
2017-06-17,121000,121000,0,1,0.0,-11154.0
2017-06-18,121000,117000,-4000,1,-4000.0,-15154.0
2017-06-19,117000,116500,-500,1,-500.0,-15654.0
2017-06-20,116500,113000,-3500,1,-3500.0,-19154.0
2017-06-21,113000,113500,500,1,500.0,-18654.0
2017-06-22,113500,113000,-500,1,-500.0,-19154.0
2017-06-23,113000,113000,0,1,0.0,-19154.0
2017-06-24,113000,113000,0,1,0.0,-19154.0
2017-06-25,113000,114000,1000,1,1000.0,-18154.0
2017-06-26,114000,114500,500,1,500.0,-17654.0
2017-06-27,114500,115500,1000,1,1000.0,-16654.0
2017-06-28,115500,116500,1000,1,1000.0,-15654.0
2017-06-29,116500,119000,2500,1,2500.0,-13154.0
2017-06-30,119000,119000,0,1,0.0,-13154.0
2017-07-01,119000,119000,0,1,0.0,-13154.0
2017-07-02,119000,120000,1000,1,1000.0,-12154.0
2017-07-03,120000,121500,1500,1,1500.0,-10654.0
2017-07-04,121500,119000,-2500,1,-2500.0,-13154.0
2017-07-05,119000,120500,1500,1,1500.0,-11654.0
2017-07-06,120500,119500,-1000,1,-1000.0,-12654.0
2017-07-07,119500,119500,0,1,0.0,-12654.0
2017-07-08,119500,119500,0,1,0.0,-12654.0
2017-07-09,119500,121000,1500,1,1500.0,-11154.0
2017-07-10,121000,121000,0,1,0.0,-11154.0
2017-07-11,121000,120500,-500,1,-500.0,-11654.0
2017-07-12,120500,121500,1000,1,1000.0,-10654.0
2017-07-13,121500,118000,-3500,1,-3500.0,-14154.0
2017-07-14,118000,118000,0,1,0.0,-14154.0
2017-07-15,118000,118000,0,1,0.0,-14154.0
2017-07-16,118000,118500,500,1,500.0,-13654.0
2017-07-17,118500,115500,-3000,1,-3000.0,-16654.0
2017-07-18,115500,117000,1500,1,1500.0,-15154.0
2017-07-19,117000,117500,500,1,500.0,-14654.0
2017-07-20,117500,120000,2500,1,2500.0,-12154.0
2017-07-21,120000,120000,0,1,0.0,-12154.0
2017-07-22,120000,120000,0,1,0.0,-12154.0
2017-07-23,120000,119000,-1000,1,-1000.0,-13154.0
2017-07-24,119000,117500,-1500,1,-1500.0,-14654.0
2017-07-25,117500,120000,2500,1,2500.0,-12154.0
2017-07-26,120000,121000,1000,1,1000.0,-11154.0
2017-07-27,121000,119500,-1500,1,-1500.0,-12654.0
2017-07-28,119500,119500,0,1,0.0,-12654.0
2017-07-29,119500,119500,0,1,0.0,-12654.0
2017-07-30,119500,118000,-1500,1,-1500.0,-14154.0
2017-07-31,118000,129500,11500,1,11500.0,-2654.0
2017-08-01,129500,127000,-2500,1,-2500.0,-5154.0
2017-08-02,127000,129000,2000,1,2000.0,-3154.0
2017-08-03,129000,129500,500,1,500.0,-2654.0
2017-08-04,129500,129500,0,1,0.0,-2654.0
2017-08-05,129500,129500,0,1,0.0,-2654.0
2017-08-06,129500,128500,-1000,1,-1000.0,-3654.0
2017-08-07,128500,129500,1000,1,1000.0,-2654.0
2017-08-08,129500,132500,3000,1,3000.0,346.0
2017-08-09,132500,133500,1000,1,1000.0,1346.0
2017-08-10,133500,131500,-2000,1,-2000.0,-654.0
2017-08-11,131500,131500,0,1,0.0,-654.0
2017-08-12,131500,131500,0,1,0.0,-654.0
2017-08-13,131500,130500,-1000,1,-1000.0,-1654.0
2017-08-14,130500,130500,0,1,0.0,-1654.0
2017-08-15,130500,127500,-3000,1,-3000.0,-4654.0
2017-08-16,127500,133000,5500,1,5500.0,846.0
2017-08-17,133000,128500,-4500,1,-4500.0,-3654.0
2017-08-18,128500,128500,0,1,0.0,-3654.0
2017-08-19,128500,128500,0,1,0.0,-3654.0
2017-08-20,128500,127500,-1000,1,-1000.0,-4654.0
2017-08-21,127500,125500,-2000,1,-2000.0,-6654.0
2017-08-22,125500,127000,1500,1,1500.0,-5154.0
2017-08-23,127000,125500,-1500,1,-1500.0,-6654.0
2017-08-24,125500,127000,1500,1,1500.0,-5154.0
2017-08-25,127000,127000,0,1,0.0,-5154.0
2017-08-26,127000,127000,0,1,0.0,-5154.0
2017-08-27,127000,126000,-1000,1,-1000.0,-6154.0
2017-08-28,126000,130000,4000,1,4000.0,-2154.0
2017-08-29,130000,129000,-1000,1,-1000.0,-3154.0
2017-08-30,129000,128000,-1000,1,-1000.0,-4154.0
2017-08-31,128000,128000,0,1,0.0,-4154.0
2017-09-01,128000,128000,0,1,0.0,-4154.0
2017-09-02,128000,128000,0,1,0.0,-4154.0
2017-09-03,128000,127500,-500,1,-500.0,-4654.0
2017-09-04,127500,127000,-500,1,-500.0,-5154.0
2017-09-05,127000,122500,-4500,1,-4500.0,-9654.0
2017-09-06,122500,125500,3000,1,3000.0,-6654.0
2017-09-07,125500,126000,500,1,500.0,-6154.0
2017-09-08,126000,126000,0,1,0.0,-6154.0
2017-09-09,126000,126000,0,1,0.0,-6154.0
2017-09-10,126000,128500,2500,1,2500.0,-3654.0
2017-09-11,128500,130500,2000,1,2000.0,-1654.0
2017-09-12,130500,136000,5500,1,5500.0,3846.0
2017-09-13,136000,135000,-1000,1,-1000.0,2846.0
2017-09-14,135000,140500,5500,1,5500.0,8346.0
2017-09-15,140500,140500,0,1,0.0,8346.0
2017-09-16,140500,140500,0,1,0.0,8346.0
2017-09-17,140500,139000,-1500,1,-1500.0,6846.0
2017-09-18,139000,138000,-1000,1,-1000.0,5846.0
2017-09-19,138000,137000,-1000,1,-1000.0,4846.0
2017-09-20,137000,138000,1000,1,1000.0,5846.0
2017-09-21,138000,133500,-4500,1,-4500.0,1346.0
2017-09-22,133500,133500,0,1,0.0,1346.0
2017-09-23,133500,133500,0,1,0.0,1346.0
2017-09-24,133500,136500,3000,1,3000.0,4346.0
2017-09-25,136500,137500,1000,1,1000.0,5346.0
2017-09-26,137500,140500,3000,1,3000.0,8346.0
2017-09-27,140500,142000,1500,1,1500.0,9846.0
2017-09-28,142000,142000,0,1,0.0,9846.0
2017-09-29,142000,142000,0,1,0.0,9846.0
2017-09-30,142000,142000,0,1,0.0,9846.0
2017-10-01,142000,142000,0,1,0.0,9846.0
2017-10-02,142000,142000,0,1,0.0,9846.0
2017-10-03,142000,142000,0,1,0.0,9846.0
2017-10-04,142000,142000,0,1,0.0,9846.0
2017-10-05,142000,142000,0,1,0.0,9846.0
2017-10-06,142000,142000,0,1,0.0,9846.0
2017-10-07,142000,142000,0,1,0.0,9846.0
2017-10-08,142000,142000,0,1,0.0,9846.0
2017-10-09,142000,142500,500,1,500.0,10346.0
2017-10-10,142500,140000,-2500,1,-2500.0,7846.0
2017-10-11,140000,141500,1500,1,1500.0,9346.0
2017-10-12,141500,143500,2000,1,2000.0,11346.0
2017-10-13,143500,143500,0,1,0.0,11346.0
2017-10-14,143500,143500,0,1,0.0,11346.0
2017-10-15,143500,145000,1500,1,1500.0,12846.0
2017-10-16,145000,142500,-2500,1,-2500.0,10346.0
2017-10-17,142500,142500,0,1,0.0,10346.0
2017-10-18,142500,144500,2000,1,2000.0,12346.0
2017-10-19,144500,144500,0,1,0.0,12346.0
2017-10-20,144500,144500,0,1,0.0,12346.0
2017-10-21,144500,144500,0,1,0.0,12346.0
2017-10-22,144500,139500,-5000,1,-5000.0,7346.0
2017-10-23,139500,139000,-500,1,-500.0,6846.0
2017-10-24,139000,141500,2500,1,2500.0,9346.0
2017-10-25,141500,142500,1000,1,1000.0,10346.0
2017-10-26,142500,140000,-2500,1,-2500.0,7846.0
2017-10-27,140000,140000,0,1,0.0,7846.0
2017-10-28,140000,140000,0,1,0.0,7846.0
2017-10-29,140000,135500,-4500,1,-4500.0,3346.0
2017-10-30,135500,134000,-1500,1,-1500.0,1846.0
2017-10-31,134000,135500,1500,1,1500.0,3346.0
2017-11-01,135500,135500,0,1,0.0,3346.0
2017-11-02,135500,136000,500,1,500.0,3846.0
2017-11-03,136000,136000,0,1,0.0,3846.0
2017-11-04,136000,136000,0,1,0.0,3846.0
2017-11-05,136000,133000,-3000,1,-3000.0,846.0
2017-11-06,133000,135500,2500,1,2500.0,3346.0
2017-11-07,135500,140000,4500,1,4500.0,7846.0
2017-11-08,140000,136000,-4000,1,-4000.0,3846.0
2017-11-09,136000,138000,2000,1,2000.0,5846.0
2017-11-10,138000,138000,0,1,0.0,5846.0
2017-11-11,138000,138000,0,1,0.0,5846.0
2017-11-12,138000,133000,-5000,1,-5000.0,846.0
2017-11-13,133000,134000,1000,1,1000.0,1846.0
2017-11-14,134000,127500,-6500,1,-6500.0,-4654.0
2017-11-15,127500,127500,0,1,0.0,-4654.0
2017-11-16,127500,127000,-500,1,-500.0,-5154.0
2017-11-17,127000,127000,0,1,0.0,-5154.0
2017-11-18,127000,127000,0,1,0.0,-5154.0
2017-11-19,127000,125500,-1500,1,-1500.0,-6654.0
2017-11-20,125500,125500,0,1,0.0,-6654.0
2017-11-21,125500,125000,-500,1,-500.0,-7154.0
2017-11-22,125000,128000,3000,1,3000.0,-4154.0
2017-11-23,128000,129000,1000,1,1000.0,-3154.0
2017-11-24,129000,129000,0,1,0.0,-3154.0
2017-11-25,129000,129000,0,1,0.0,-3154.0
2017-11-26,129000,126000,-3000,1,-3000.0,-6154.0
2017-11-27,126000,127500,1500,1,1500.0,-4654.0
2017-11-28,127500,127000,-500,1,-500.0,-5154.0
2017-11-29,127000,126000,-1000,1,-1000.0,-6154.0
2017-11-30,126000,124500,-1500,1,-1500.0,-7654.0
2017-12-01,124500,124500,0,1,0.0,-7654.0
2017-12-02,124500,124500,0,1,0.0,-7654.0
2017-12-03,124500,123000,-1500,1,-1500.0,-9154.0
2017-12-04,123000,132500,9500,1,9500.0,346.0
2017-12-05,132500,130000,-2500,1,-2500.0,-2154.0
2017-12-06,130000,126500,-3500,1,-3500.0,-5654.0
2017-12-07,126500,124500,-2000,1,-2000.0,-7654.0
2017-12-08,124500,124500,0,1,0.0,-7654.0
2017-12-09,124500,124500,0,1,0.0,-7654.0
2017-12-10,124500,126000,1500,1,1500.0,-6154.0
2017-12-11,126000,125000,-1000,1,-1000.0,-7154.0
2017-12-12,125000,127500,2500,1,2500.0,-4654.0
2017-12-13,127500,123000,-4500,1,-4500.0,-9154.0
2017-12-14,123000,122500,-500,1,-500.0,-9654.0
2017-12-15,122500,122500,0,1,0.0,-9654.0
2017-12-16,122500,122500,0,1,0.0,-9654.0
2017-12-17,122500,120500,-2000,1,-2000.0,-11654.0
2017-12-18,120500,117500,-3000,1,-3000.0,-14654.0
2017-12-19,117500,123500,6000,1,6000.0,-8654.0
2017-12-20,123500,124500,1000,1,1000.0,-7654.0
2017-12-21,124500,122500,-2000,1,-2000.0,-9654.0
2017-12-22,122500,122500,0,1,0.0,-9654.0
2017-12-23,122500,122500,0,1,0.0,-9654.0
2017-12-24,122500,122500,0,1,0.0,-9654.0
2017-12-25,122500,124500,2000,1,2000.0,-7654.0
2017-12-26,124500,115500,-9000,1,-9000.0,-16654.0
2017-12-27,115500,113000,-2500,1,-2500.0,-19154.0
2017-12-28,113000,113000,0,1,0.0,-19154.0
2017-12-29,113000,113000,0,1,0.0,-19154.0
2017-12-30,113000,113000,0,1,0.0,-19154.0
2017-12-31,113000,113000,0,1,0.0,-19154.0
2018-01-01,113000,113500,500,1,500.0,-18654.0
2018-01-02,113500,115000,1500,1,1500.0,-17154.0
2018-01-03,115000,119000,4000,1,4000.0,-13154.0
2018-01-04,119000,117500,-1500,1,-1500.0,-14654.0
2018-01-05,117500,117500,0,1,0.0,-14654.0
2018-01-06,117500,117500,0,1,0.0,-14654.0
2018-01-07,117500,115000,-2500,1,-2500.0,-17154.0
2018-01-08,115000,119000,4000,1,4000.0,-13154.0
2018-01-09,119000,125000,6000,1,6000.0,-7154.0
2018-01-10,125000,126000,1000,1,1000.0,-6154.0
2018-01-11,126000,127000,1000,1,1000.0,-5154.0
2018-01-12,127000,127000,0,1,0.0,-5154.0
2018-01-13,127000,127000,0,1,0.0,-5154.0
2018-01-14,127000,125500,-1500,1,-1500.0,-6654.0
2018-01-15,125500,121000,-4500,1,-4500.0,-11154.0
2018-01-16,121000,122000,1000,1,1000.0,-10154.0
2018-01-17,122000,116500,-5500,1,-5500.0,-15654.0
2018-01-18,116500,117500,1000,1,1000.0,-14654.0
2018-01-19,117500,117500,0,1,0.0,-14654.0
2018-01-20,117500,117500,0,1,0.0,-14654.0
2018-01-21,117500,116000,-1500,1,-1500.0,-16154.0
2018-01-22,116000,115500,-500,1,-500.0,-16654.0
2018-01-23,115500,113500,-2000,1,-2000.0,-18654.0
2018-01-24,113500,116500,3000,1,3000.0,-15654.0
2018-01-25,116500,115000,-1500,1,-1500.0,-17154.0
2018-01-26,115000,115000,0,1,0.0,-17154.0
2018-01-27,115000,115000,0,1,0.0,-17154.0
2018-01-28,115000,118500,3500,1,3500.0,-13654.0
2018-01-29,118500,118500,0,1,0.0,-13654.0
2018-01-30,118500,118500,0,1,0.0,-13654.0
2018-01-31,118500,116500,-2000,1,-2000.0,-15654.0
2018-02-01,116500,114000,-2500,1,-2500.0,-18154.0
2018-02-02,114000,114000,0,1,0.0,-18154.0
2018-02-03,114000,114000,0,1,0.0,-18154.0
2018-02-04,114000,110500,-3500,1,-3500.0,-21654.0
2018-02-05,110500,107500,-3000,1,-3000.0,-24654.0
2018-02-06,107500,105500,-2000,1,-2000.0,-26654.0
2018-02-07,105500,108000,2500,1,2500.0,-24154.0
2018-02-08,108000,113500,5500,1,5500.0,-18654.0
2018-02-09,113500,113500,0,1,0.0,-18654.0
2018-02-10,113500,113500,0,1,0.0,-18654.0
2018-02-11,113500,109000,-4500,1,-4500.0,-23154.0
2018-02-12,109000,105000,-4000,1,-4000.0,-27154.0
2018-02-13,105000,104500,-500,1,-500.0,-27654.0
2018-02-14,104500,104500,0,1,0.0,-27654.0
2018-02-15,104500,104500,0,1,0.0,-27654.0
2018-02-16,104500,104500,0,1,0.0,-27654.0
2018-02-17,104500,104500,0,1,0.0,-27654.0
2018-02-18,104500,106000,1500,1,1500.0,-26154.0
2018-02-19,106000,106500,500,1,500.0,-25654.0
2018-02-20,106500,106000,-500,1,-500.0,-26154.0
2018-02-21,106000,103500,-2500,1,-2500.0,-28654.0
2018-02-22,103500,105000,1500,1,1500.0,-27154.0
2018-02-23,105000,105000,0,1,0.0,-27154.0
2018-02-24,105000,105000,0,1,0.0,-27154.0
2018-02-25,105000,103500,-1500,1,-1500.0,-28654.0
2018-02-26,103500,102000,-1500,1,-1500.0,-30154.0
2018-02-27,102000,100000,-2000,1,-2000.0,-32154.0
2018-02-28,100000,100000,0,1,0.0,-32154.0
2018-03-01,100000,98700,-1300,1,-1300.0,-33454.0
2018-03-02,98700,98700,0,1,0.0,-33454.0
2018-03-03,98700,98700,0,1,0.0,-33454.0
2018-03-04,98700,96200,-2500,1,-2500.0,-35954.0
2018-03-05,96200,97300,1100,1,1100.0,-34854.0
2018-03-06,97300,95400,-1900,1,-1900.0,-36754.0
2018-03-07,95400,97800,2400,1,2400.0,-34354.0
2018-03-08,97800,101500,3700,1,3700.0,-30654.0
2018-03-09,101500,101500,0,1,0.0,-30654.0
2018-03-10,101500,101500,0,1,0.0,-30654.0
2018-03-11,101500,105500,4000,1,4000.0,-26654.0
2018-03-12,105500,104000,-1500,1,-1500.0,-28154.0
2018-03-13,104000,104500,500,1,500.0,-27654.0
2018-03-14,104500,102000,-2500,1,-2500.0,-30154.0
2018-03-15,102000,103500,1500,1,1500.0,-28654.0
2018-03-16,103500,103500,0,1,0.0,-28654.0
2018-03-17,103500,103500,0,1,0.0,-28654.0
2018-03-18,103500,107000,3500,1,3500.0,-25154.0
2018-03-19,107000,106500,-500,1,-500.0,-25654.0
2018-03-20,106500,105000,-1500,1,-1500.0,-27154.0
2018-03-21,105000,109000,4000,1,4000.0,-23154.0
2018-03-22,109000,105000,-4000,1,-4000.0,-27154.0
2018-03-23,105000,105000,0,1,0.0,-27154.0
2018-03-24,105000,105000,0,1,0.0,-27154.0
2018-03-25,105000,105500,500,1,500.0,-26654.0
2018-03-26,105500,107000,1500,1,1500.0,-25154.0
2018-03-27,107000,106000,-1000,1,-1000.0,-26154.0
2018-03-28,106000,107000,1000,1,1000.0,-25154.0
2018-03-29,107000,106500,-500,1,-500.0,-25654.0
2018-03-30,106500,106500,0,1,0.0,-25654.0
2018-03-31,106500,106500,0,1,0.0,-25654.0
2018-04-01,106500,102500,-4000,1,-4000.0,-29654.0
2018-04-02,102500,102500,0,1,0.0,-29654.0
2018-04-03,102500,101000,-1500,1,-1500.0,-31154.0
2018-04-04,101000,102500,1500,1,1500.0,-29654.0
2018-04-05,102500,102500,0,1,0.0,-29654.0
2018-04-06,102500,102500,0,1,0.0,-29654.0
2018-04-07,102500,102500,0,1,0.0,-29654.0
2018-04-08,102500,100000,-2500,1,-2500.0,-32154.0
2018-04-09,100000,100500,500,1,500.0,-31654.0
2018-04-10,100500,103000,2500,1,2500.0,-29154.0
2018-04-11,103000,106500,3500,1,3500.0,-25654.0
2018-04-12,106500,105500,-1000,1,-1000.0,-26654.0
2018-04-13,105500,105500,0,1,0.0,-26654.0
2018-04-14,105500,105500,0,1,0.0,-26654.0
2018-04-15,105500,106000,500,1,500.0,-26154.0
2018-04-16,106000,107500,1500,1,1500.0,-24654.0
2018-04-17,107500,108500,1000,1,1000.0,-23654.0
2018-04-18,108500,111500,3000,1,3000.0,-20654.0
2018-04-19,111500,109000,-2500,1,-2500.0,-23154.0
2018-04-20,109000,109000,0,1,0.0,-23154.0
2018-04-21,109000,109000,0,1,0.0,-23154.0
2018-04-22,109000,113000,4000,1,4000.0,-19154.0
2018-04-23,113000,112500,-500,1,-500.0,-19654.0
2018-04-24,112500,111500,-1000,1,-1000.0,-20654.0
2018-04-25,111500,113000,1500,1,1500.0,-19154.0
2018-04-26,113000,115000,2000,1,2000.0,-17154.0
2018-04-27,115000,115000,0,1,0.0,-17154.0
2018-04-28,115000,115000,0,1,0.0,-17154.0
2018-04-29,115000,121000,6000,1,6000.0,-11154.0
2018-04-30,121000,121000,0,1,0.0,-11154.0
2018-05-01,121000,121000,0,1,0.0,-11154.0
2018-05-02,121000,120000,-1000,1,-1000.0,-12154.0
2018-05-03,120000,120500,500,1,500.0,-11654.0
2018-05-04,120500,120500,0,1,0.0,-11654.0
2018-05-05,120500,120500,0,1,0.0,-11654.0
2018-05-06,120500,120500,0,1,0.0,-11654.0
2018-05-07,120500,118000,-2500,1,-2500.0,-14154.0
2018-05-08,118000,117500,-500,1,-500.0,-14654.0
2018-05-09,117500,119500,2000,1,2000.0,-12654.0
2018-05-10,119500,117000,-2500,1,-2500.0,-15154.0
2018-05-11,117000,117000,0,1,0.0,-15154.0
2018-05-12,117000,117000,0,1,0.0,-15154.0
2018-05-13,117000,120000,3000,1,3000.0,-12154.0
2018-05-14,120000,120000,0,1,0.0,-12154.0
2018-05-15,120000,118000,-2000,1,-2000.0,-14154.0
2018-05-16,118000,117000,-1000,1,-1000.0,-15154.0
2018-05-17,117000,117500,500,1,500.0,-14654.0
2018-05-18,117500,117500,0,1,0.0,-14654.0
2018-05-19,117500,117500,0,1,0.0,-14654.0
2018-05-20,117500,115000,-2500,1,-2500.0,-17154.0
2018-05-21,115000,115000,0,1,0.0,-17154.0
2018-05-22,115000,113500,-1500,1,-1500.0,-18654.0
2018-05-23,113500,110000,-3500,1,-3500.0,-22154.0
2018-05-24,110000,109000,-1000,1,-1000.0,-23154.0
2018-05-25,109000,109000,0,1,0.0,-23154.0
2018-05-26,109000,109000,0,1,0.0,-23154.0
2018-05-27,109000,110500,1500,1,1500.0,-21654.0
2018-05-28,110500,108000,-2500,1,-2500.0,-24154.0
2018-05-29,108000,105500,-2500,1,-2500.0,-26654.0
2018-05-30,105500,104500,-1000,1,-1000.0,-27654.0
2018-05-31,104500,106000,1500,1,1500.0,-26154.0
2018-06-01,106000,106000,0,1,0.0,-26154.0
2018-06-02,106000,106000,0,1,0.0,-26154.0
2018-06-03,106000,106500,500,1,500.0,-25654.0
2018-06-04,106500,107500,1000,1,1000.0,-24654.0
2018-06-05,107500,107500,0,1,0.0,-24654.0
2018-06-06,107500,108500,1000,1,1000.0,-23654.0
2018-06-07,108500,106500,-2000,1,-2000.0,-25654.0
2018-06-08,106500,106500,0,1,0.0,-25654.0
2018-06-09,106500,106500,0,1,0.0,-25654.0
2018-06-10,106500,109000,2500,1,2500.0,-23154.0
2018-06-11,109000,107500,-1500,1,-1500.0,-24654.0
2018-06-12,107500,107500,0,1,0.0,-24654.0
2018-06-13,107500,105500,-2000,1,-2000.0,-26654.0
2018-06-14,105500,108000,2500,1,2500.0,-24154.0
2018-06-15,108000,108000,0,1,0.0,-24154.0
2018-06-16,108000,108000,0,1,0.0,-24154.0
2018-06-17,108000,104500,-3500,1,-3500.0,-27654.0
2018-06-18,104500,104500,0,1,0.0,-27654.0
2018-06-19,104500,104000,-500,1,-500.0,-28154.0
2018-06-20,104000,101000,-3000,1,-3000.0,-31154.0
2018-06-21,101000,100500,-500,1,-500.0,-31654.0
2018-06-22,100500,100500,0,1,0.0,-31654.0
2018-06-23,100500,100500,0,1,0.0,-31654.0
2018-06-24,100500,102500,2000,1,2000.0,-29654.0
2018-06-25,102500,104000,1500,1,1500.0,-28154.0
2018-06-26,104000,102000,-2000,1,-2000.0,-30154.0
2018-06-27,102000,104500,2500,1,2500.0,-27654.0
2018-06-28,104500,104000,-500,1,-500.0,-28154.0
2018-06-29,104000,104000,0,1,0.0,-28154.0
2018-06-30,104000,104000,0,1,0.0,-28154.0
2018-07-01,104000,99900,-4100,1,-4100.0,-32254.0
2018-07-02,99900,99800,-100,1,-100.0,-32354.0
2018-07-03,99800,99000,-800,1,-800.0,-33154.0
2018-07-04,99000,99500,500,1,500.0,-32654.0
2018-07-05,99500,102500,3000,1,3000.0,-29654.0
2018-07-06,102500,102500,0,1,0.0,-29654.0
2018-07-07,102500,102500,0,1,0.0,-29654.0
2018-07-08,102500,101500,-1000,1,-1000.0,-30654.0
2018-07-09,101500,100000,-1500,1,-1500.0,-32154.0
2018-07-10,100000,101000,1000,1,1000.0,-31154.0
2018-07-11,101000,100500,-500,1,-500.0,-31654.0
2018-07-12,100500,100000,-500,1,-500.0,-32154.0
2018-07-13,100000,100000,0,1,0.0,-32154.0
2018-07-14,100000,100000,0,1,0.0,-32154.0
2018-07-15,100000,100000,0,1,0.0,-32154.0
2018-07-16,100000,99300,-700,1,-700.0,-32854.0
2018-07-17,99300,98300,-1000,1,-1000.0,-33854.0
2018-07-18,98300,97300,-1000,1,-1000.0,-34854.0
2018-07-19,97300,96600,-700,1,-700.0,-35554.0
2018-07-20,96600,96600,0,1,0.0,-35554.0
2018-07-21,96600,96600,0,1,0.0,-35554.0
2018-07-22,96600,96600,0,1,0.0,-35554.0
2018-07-23,96600,98000,1400,1,1400.0,-34154.0
2018-07-24,98000,99800,1800,1,1800.0,-32354.0
2018-07-25,99800,100000,200,1,200.0,-32154.0
2018-07-26,100000,101500,1500,1,1500.0,-30654.0
2018-07-27,101500,101500,0,1,0.0,-30654.0
2018-07-28,101500,101500,0,1,0.0,-30654.0
2018-07-29,101500,101500,0,1,0.0,-30654.0
2018-07-30,101500,104000,2500,1,2500.0,-28154.0
2018-07-31,104000,104500,500,1,500.0,-27654.0
2018-08-01,104500,104000,-500,1,-500.0,-28154.0
2018-08-02,104000,109000,5000,1,5000.0,-23154.0
2018-08-03,109000,109000,0,1,0.0,-23154.0
2018-08-04,109000,109000,0,1,0.0,-23154.0
2018-08-05,109000,108500,-500,1,-500.0,-23654.0
2018-08-06,108500,107500,-1000,1,-1000.0,-24654.0
2018-08-07,107500,109500,2000,1,2000.0,-22654.0
2018-08-08,109500,109000,-500,1,-500.0,-23154.0
2018-08-09,109000,111000,2000,1,2000.0,-21154.0
2018-08-10,111000,111000,0,1,0.0,-21154.0
2018-08-11,111000,111000,0,1,0.0,-21154.0
2018-08-12,111000,107000,-4000,1,-4000.0,-25154.0
2018-08-13,107000,109000,2000,1,2000.0,-23154.0
2018-08-14,109000,109000,0,1,0.0,-23154.0
2018-08-15,109000,110000,1000,1,1000.0,-22154.0
2018-08-16,110000,109500,-500,1,-500.0,-22654.0
2018-08-17,109500,109500,0,1,0.0,-22654.0
2018-08-18,109500,109500,0,1,0.0,-22654.0
2018-08-19,109500,109500,0,1,0.0,-22654.0
2018-08-20,109500,107000,-2500,1,-2500.0,-25154.0
2018-08-21,107000,106500,-500,1,-500.0,-25654.0
2018-08-22,106500,109000,2500,1,2500.0,-23154.0
2018-08-23,109000,108000,-1000,1,-1000.0,-24154.0
2018-08-24,108000,108000,0,1,0.0,-24154.0
2018-08-25,108000,108000,0,1,0.0,-24154.0
2018-08-26,108000,107500,-500,1,-500.0,-24654.0
2018-08-27,107500,112500,5000,1,5000.0,-19654.0
2018-08-28,112500,116000,3500,1,3500.0,-16154.0
2018-08-29,116000,117500,1500,1,1500.0,-14654.0
2018-08-30,117500,117000,-500,1,-500.0,-15154.0
2018-08-31,117000,117000,0,1,0.0,-15154.0
2018-09-01,117000,117000,0,1,0.0,-15154.0
2018-09-02,117000,120500,3500,1,3500.0,-11654.0
2018-09-03,120500,120500,0,1,0.0,-11654.0
2018-09-04,120500,121500,1000,1,1000.0,-10654.0
2018-09-05,121500,125000,3500,1,3500.0,-7154.0
2018-09-06,125000,127500,2500,1,2500.0,-4654.0
2018-09-07,127500,127500,0,1,0.0,-4654.0
2018-09-08,127500,127500,0,1,0.0,-4654.0
2018-09-09,127500,126000,-1500,1,-1500.0,-6154.0
2018-09-10,126000,136000,10000,1,10000.0,3846.0
2018-09-11,136000,136500,500,1,500.0,4346.0
2018-09-12,136500,139000,2500,1,2500.0,6846.0
2018-09-13,139000,140500,1500,1,1500.0,8346.0
2018-09-14,140500,140500,0,1,0.0,8346.0
2018-09-15,140500,140500,0,1,0.0,8346.0
2018-09-16,140500,139000,-1500,1,-1500.0,6846.0
2018-09-17,139000,143000,4000,1,4000.0,10846.0
2018-09-18,143000,143000,0,0,0.0,10846.0
